load_data( { book: 'ta_nvd', text: '&lt;غدق&gt;الغَدَق مُحرّكة : الماءُ الكثير وإن لم يكُ مطَراً .<br>\
وقيل : هو المطَر الكثيرُ العامُّ .<br>\
وقوله تعالى : ) وأنْ لو اسْتَقاموا على الطّريقَةِ لأسْقَيْناهُم ماءً غدَقاً لنَفْتِنَهُمْ فيه ( قال ثعْلَب : أي طَريقَة الكُفْر لفَتَحنا عليهم باب اغْتِرار ، كقوله تَعالى : ) لجَعَلْنا لمَنْ يكفُرُ بالرّحْمنِ لبُيوتِهم سُقُفاً من فِضّة ( وقال الفَرّاءُ : أي لزِدْنا في أموالِهم فِتْنةً عليهم وبَليّةً .<br>\
وقال غيرُهما : أي على طَريقَة الهُدَى لأسقَيناهم ماءً كثيراً .<br>\
ودليلُ هذا قولُه تعالى : ) ولو أنّ أهْلَ القُرَى آمَنوا واتّقوا لفَتَحْنا علَيْهِم برَكاتٍ منَ السّماءِ ( .<br>\
والحَسَنُ بنُ بِشْرِ بنِ إسْماعِيلَ بن غَدَق : مُحدِّثٌ ، وهو شيخٌ لعَبْد الغَنيّ المِصْري الحافِظ .<br>\
وغَدِقت العَينُ ، كفَرِح : غَزُرَتْ وعَذُبَت ، فهي غَدِقة .<br>\
وبئْرُ غَدَقٍ ، مُحرَّكةً مُضافةً مَعْروفةٌ بالمَدينةِ ، على ساكنِها أفضَلُ الصّلاةِ والسّلامِ ، وعندها أُطُمُ البَلَويّين الذي يقال له القاعُ .<br>\
وشابٌّ غَيْدَقٌ ، وكذا شَبابٌ غيْدَقٌ ، وغَيْدَقانُ ، وغَيْداقٌ أي : ناعِمٌ رَخْصٌ .<br>\
وأنشد اللّيْثُ : بعدَ التّصابي والشّبابِ الغَيْدَقِ وأنشد أيضاً : رُبّ خليلٍ ليَ غيْداقٍ رَفِلْ وأنشد أيضاً : جعْدَ العَناصِي غيْدَقاناً أغْيَدا وقيلَ : الغَيْداقُ من الغِلْمانِ : الذي لم يَبْلُغ .<br>\
والغَيْداقُ : الرّجُل الكَريمُ نقَله الجوهَريُّ ، الجوادُ الواسعُ الخُلُق الكثير العَطيّة ، وبه سُمّي أحد عُمومَتِه صلّى الله عليه وسلم غَيْداقاً لكَثْرَة عَطائِه .<br>\
والغَيْداقُ : ولدُ الضّبِّ .<br>\
قال أبو زيد : أول حِسْل ، ثم غَيْداق ، ثم مُطَبِّخ ، ثم يكونُ ضَبّاً مُدرِكاً .<br>\
قال )<br>\
الجوهَريّ : ولم يذكر الخُضَرِمَ بعد المُطَبِّخ ، وذكره خَلَفٌ الأحْمَر .<br>\
وقال غيرُه : هو الضّبُّ بين الضّبّيْنِ ، وقيلَ : هو الضّبُّ المُسِنُّ العَظيم .<br>\
والغَيْداقُ : الطّويلُ من الخَيْل ذكَره صاحبُ الأبْنِية ، وهو قول السّيرافيّ .<br>\
والغَيْدَقان : الناعِم ، وهذا قد تقدّم ، ففيه تَكرار .<br>\
وقيلَ : هو الكَريم الواسِعُ الخُلُقِ الكَثير العَطيّة .<br>\
وقيل : الكَثيرُ الواسعُ من كل شيء .<br>\
والغَيادِيقُ : الحيّاتُ .<br>\
كما في اللِّسان والعُباب .<br>\
وأغدَقَ المطَر إغْداقاً ، فهو مُغْدِقٌ .<br>\
واغْدَوْدَق : كثُر قَطْرُه .<br>\
ومطر مُغْدَودِقٌ ، وماءٌ مُغْدَودِقٌ : كثيرٌ .<br>\
ومنه الحَديث : اللهُمّ اسْقِنا غَدَقاً مُغْدِقاً ، أكّدَه به .<br>\
وغَيْدَقَ الرّجُلُ : كثُر بُزاقُه كذا نصُّ المُحيط .<br>\
وفي اللّسان : لُعابُه ، وهو مَجاز .<br>\
ومما يُستَدرك عليه : غيْدَقَ المطَر : كثُر ، عن أبي العَمَيْثَل الأعرابيّ .<br>\
وقال الزّجّاجُ : الغَدَقُ المَصْدر ، والغَدِقُ اسمُ الفاعِل .<br>\
يُقال : غَدِقَ يغدَقُ غَدَقاً ، فهو غَدِقٌ : إذا كثُر النّدى في المكان أو الماءُ .<br>\
قال : ويُقرَأ ) ماءً غدِقاً ( قلتُ : ورُوِيتْ عن عاصِمِ بن أبي النّجود .<br>\
وأرضٌ غَدِقَةٌ : في غايةِ الرِّيّ ، وهي النّدِيّةُ المُبْتَلّة الرَّيا الكَثيرةُ الماءِ .<br>\
وعُشْب غدِقٌ بَيِّنُ الغَدَق : ريّانُ مُبْتَلٌّ رواه أبو حَنيفة ، وعَزاه إلى النّضْر .<br>\
وغَدِقَت الأرضُ غَدَقاً وأغْدَقَت : أخْصَبَتْ .<br>\
وماءٌ غَيْداقٌ : غَزيرٌ .<br>\
وعام غَيْداقٌ : مُخصِب ، وكذلك السّنَة بغَيْر هاءٍ .<br>\
وقال أبو عمْرو : غيْثٌ غيداقٌ : كثيرُ الماءِ .<br>\
وعيْشٌ غيْدَقٌ وغَيْداقٌ : واسع مُخصِبٌ ، وهم في غَدَق من العيْش ، وغَيْداقٍ .<br>\
وفي الحديث : إذا نشأَت السّحابَةُ من قِبَل العينِ فتِلْكَ عينٌ غُدَيْقَة أي : كَثيرةُ الماء ، هكذا جاءَت مُصغّرة ، وهي من تَصْغير التّعْظيم .<br>\
وإنه لَغيْداقُ الجَرْيِ والعَدْو : واسِعُهما .<br>\
قال تأبّط شرّاً :  ( حتّى نجَوْتُ ولمّا ينزِعوا سَلَبي  بوالِهٍ من قَنيصِ الشّدِّ غيْداقِ )<br>\
وشَدٌّ غَيْداقٌ ، وهو الحُضْرُ الشّديدُ .<br>\
وشَبابٌ غُداقِيٌّ : ناعِم .<br>\
' } );