load_data( { book: 'ta_nvd', text: '&lt;زعق&gt;الزُّعاقُ ، كغُرابٍ : الماءُ المُرُّ الغَلِيظُ الذي لا يُطاقُ شرْبُه من أُجُوجَتِه ، قالَهُ اللَّيْثُ ، الواحِدُ والجَميعُ فيهِ سواءٌ ، قالَ : وإِذا كَثُرَ مِلْحُ الشَّيْءَ حَتى يَصِيرَ إِلى المَرارَةِ ، فأكَلْتَه ، قُلْتَ : أَكَلْتُه زُعاقاً ، ويُرْوَى أنَّ علِياً رضِيَ اللهُ عنه قال يَوْمَ خَيبَر : دونَكَها مُتْرَعَةً دِهاقَا كَأساً زُعافاً مُزِجَتْ زُعاقَا زَعُقَ ، ككَرُمَ صارَ مُراً .<br>\
وقالَ بن فارِسٍ : الزُّعاق : النِّفارُ .<br>\
ويُقالُ أَيْضاً : وَعِلٌ زُعاقٌ ، أَي : نَفُورٌ .<br>\
وطَعامٌ مَزْعُوقٌ وزُعاقٌ : إِذا كَثرَ مِلْحُه .<br>\
وزَعَقَه زَعْقاً .<br>\
وزَعَقَ بهِ زَعْقاً كمَنَعَه : إذا ذَعَرَه وأَفزعَهُ كأَزْعَقَه ، فهو زَعِيقٌ .<br>\
وقالَ الأَصْمَعِيُّ : يُقال : أَزْعَقْتُه فهُو مَزْعُوقٌ على غَيْرِ قِياسٍ ، وأَنْشَدَ : يا رُبَّ مُهْرٍ مزْعُوقْ مُقَيَّلٍ أَو مَغْبُوقْ من لَبْنِ الدُّهمِ الرُّوقْ كذا في الصِّحاح ، وقالَ الأَمَوِيُّ : زَعقْتُه فهو مَزْعُوقٌ .<br>\
قلتُ : فَعَلى هذا لا يَشِذُّ عن القِياسِ .<br>\
وزَعَقَ بدَوابِّه زَعْقاً : صاح بها ، و طَرَدَها مُسْرِعاً ، قال الرّاجِزُ : إِن عَلَيْها فاعْلَمَنَّ سائِقَا )<br>\
لا مُبْطِئاً ولا عَنيفاً زاعِقَا لَبّاً بأَعجازِ المَطِىِّ لاحِقَا وقِيلَ .<br>\
الزّاعِقُ : الذى يسُوقُ ويَصِيحُ بها صِياحاً شَدِيدًا .<br>\
وزَعَقَ القِدْرُ يَزْعَقْها زَعْقاً : كَثَّرَ مِلْحَها فهي مَزْعُوقَةٌ كأَزْعَقَها .<br>\
وزَعَقتِ الرِّيحُ التُّرابَ : أَثارتْهُ وفي حاشِيَةَِ بن بَريّ : أمارَتْهُ .<br>\
وزَعَقَت العَقْرَبُ فُلاناً : لَدَغَتْهُ كما في اللِّسانِ .<br>\
وفي نوادِرِ العَرَب : أَرْضٌ مَزْعُوقَة ومَدْعُوقَةٌ ، ومَمْعُوقَةٌ ، ومَبْعُوقَةٌ : إِذا أصابَها مَطَر وابِلٌ شَدِيدٌ .<br>\
وزَعقَ كفَرِحَ زَعَقاً .<br>\
وكذا : زُعِقَ ، مثل عُنِى : خاف وفَزِعَ باللَّيْلِ ولم يُقَيِّدْه في التَّهْذِيب باللَّيْلِ .<br>\
وزَعِقَ يَزْعَقُ زَعَقاً أَيْضاً : نَشِطَ ، فهو زَعِقٌ ، ككَتِفٍ فيهِما ، أَي : مَذْعُورٌ ونَشِيِطٌ ، وفي الصِّحاح : الزَّعِقُ : هو<br>\
النَّشِيطُ الذي يَفْزَعُ مع نَشاطِه ، ومثله في العُبابِ .<br>\
وزَعَقَ كمَنَعَ زَعْقاً : صاحَ وقد زَعَقَ زَعْقاً ، لُغَةٌ شاميّةٌ .<br>\
وفَرَسٌ زَعّاقٌ ، كشَدّادٍ : مَشّاءٌ عن ابن عَبّادٍ ، قال : وعَجُولٌ أيضاً .<br>\
قال : وسَيْرٌ مِزْعَقٌ ، كمِنْبَرٍ أَي سريعٌ .<br>\
قال : ونَزَعَ في القَوْسِ نَزْعاً مِزْعَقاً أيضاً بمعنى سَرِيعاً .<br>\
قال : والمِزْعَقُ : المِقْلاعُ يُقْلَعُ به الأَرضُونَ .<br>\
والزُّعْقُوقَةُ بالضم : فَرْخُ القَبْجِ .<br>\
قاله اللّيْثُ : وهو الحَجَلُ والكَرَوانُ ، والجمعُ الزَّعاقِيقُ ، وأَنْشَدَ :  ( كأَنَّ الزَّعاقِيقَ والحَيْقُطان  يُبادِرْنَ في المَنْزِلِ الضَّيْوَنَا )  وأَزْعَقُوا : حَفَرُوا فَهَجَمُوا على ماءٍ زُعاقٍ أَي : ملْحٍ .<br>\
أَزْعَقُوا فُلاناً : خَوفوهُ حَتّى زَعِقَ .<br>\
قالَ ابنُ عَبادٍ : أزْعَقُوا السَّيرَ : عَجلُوا .<br>\
قالَ : وانْزَعَقتِ الدَّوَابُّ : إذا أَسْرَعت قالَ : وانْزَعَق الفَرس أي : تقَّدَّمَ .<br>\
قالَ غيرُه : انْزَعَقَ فلان : خافَ باللَّيْلِ ولم يُقَيَّدْ في العُباب والتَّهْذِيبِ باللَّيْلِ .<br>\
ومما يستَدرَكُ عليه : أزْعَقَ : أَنبَطَ ماءً زُعاقاً .<br>\
وبئْرٌ زَعِقَةٌ ، كفَرِحَةٍ : ماؤُها زعاق .<br>\
ورجُلٌ مزْعُوقٌ : ذكي الفُؤادِ .<br>\
ومُهْر مَزْعُوقٌ : مُبالغ في غِذائِه ، وبه فسِّرَ قولُ الرّاجزِ السابق أَيْضاً ، قاله الجوهرِي .<br>\
وهَوْل زعِقٌ ، ككَتفٍ : شَدِيد ، قال : من عائلاتِ اللَّيْلِ والهَوْلِ أتزعق<br>\
والرعاف ، كشَدّادٍ : من يَطرد الدواب ويَصيحُ في آثارِها ، وهو الناعِق ، والنغاز .<br>\
وزعق المؤَذَنِ : صَوْته .<br>\
' } );