load_data( { book: 'ta_nvd', text: '&lt;جزل&gt;الجَزْلُ : الحَطَبُ اليابِسُ ، أو الغَلِيظُ العَظِيمُ منه وأنشد ثَعْلَب :  ( فوَيْهاً لِقِدرِكَ وَيْهاً لَها  إذا اخْتِيرَ في المَحْلِ جَزْلُ الحَطَبْ )<br>\
وقال ابنُ مُقْبِل :  ( باتَتْ حَواطِبُ لَيلَى يَلْتَمِسْنَ لَها  جَزْلَ الجِذَى غيرَ خَوَّارٍ ولا دَعِرِ )  مِن المَجاز : الجَزْلُ : الكَثِيرُ مِن الشيء ، كالجَزِيلِ كأَمِيرٍ ، يقال : له عَطاءٌ جَزْلٌ وجَزِيلٌ ، ويقال : إن فعلَته فلك ذِكرٌ جَميلٌ وثوابٌ جَزِيل .<br>\
ج : جِزالٌ كجِبالٍ يَحْتَمِلُ أن يكونَ بالجيم ، فيكون جمعَ جَزِيلٍ ، أو بالحاء فيكونَ جمعَ جَزْلٍ ، كحَبلٍ وحِبالٍ .<br>\
مِن المجاز : الجَزْلُ : الكَرِيمُ المِعْطاءُ ، أيضاً : العاقِلُ الأَصِيلُ الرأي .<br>\
وفي الأساس : وإن قِيل لك : فُلانٌ جَزْلُ الرأي ، فأردتَ إنكارَه ، فقل : بَل جَزِلُ الرأي : أي فاسِدُه ، مِن الجَزَلِ في الغارِب : وهو حُدوثُ دَبَرَةٍ فيه تَهْجُم على الجَوْفِ فتُهْلِكُه ، كما سيأتي .<br>\
وهي جَزْلَةٌ وجَزْلاءُ : ذاتُ رأي .<br>\
مِن المَجاز : الجَزْلُ : خِلافُ الرَّكِيكِ مِن الألفاظ .<br>\
قال ابنُ عَبّاد : الجَزْلُ : صَوتُ الحَمامِ .<br>\
قال ابنُ سِيدَهْ : الجَزْلُ : إسقاطُ الرابعِ مِن مُتَفاعِلُنْ ، وإسكانُ ثانيه في زِحافِ الكامِلِ وقال قوم : هو الخَزْلُ ، بالخاء المُعْجَمَة .<br>\
وقد جَزَلَهُ يَجْزِلُه جَزْلاً .<br>\
أو سُمِّيَ مَجْزُولاً لأن رابِعَه وسَطُه ، فشُبِّه بالسَّنامِ المَجْزُولِ الذي أصابَتْهُ الدَّبَرَةُ .<br>\
الجَزْلُ : نَباتٌ .<br>\
الجُزْلُ بالضمّ : جَمعُ الأَجْزَلِ مِن الجِمال وهي التي أصاب غارِبَها جَزَلٌ .<br>\
والجَزْلَةُ : العَظِيمَةُ العَجُزِ والأَرْدافِ ، وهو مَجازٌ .<br>\
الجَزْلَةُ : البَقِيةُ مِن الرَّغِيف يقال : أعطاه جَزْلَةً مِن رَغِيف : أي قِطْعةً منه ، كما في الأساس .<br>\
الجَزْلَةُ : الوَطْبُ والجُلَّةُ .<br>\
الجِزْلَةُ بالكسر : القِطْعةُ العَظيمةُ من التَّمْرِ ، كالجِزْلِ بغير هاءٍ .<br>\
وجَزَلَهُ بالسَّيفِ يَجْزِلُه جَزْلاً : قَطَعَهُ جِزْلَتَينْ أي : قِطْعَتينْ ، ومنه حديثُ الدَّجال : أنه يدعو رجُلاً مُمتَلِئاً شابّاً ، فيضربُه بالسَّيف فيقطَعُه جِزْلَتَيْن ، ثم يَدْعُوه فيُقْبِلُ يتَهَلَّل وجهُه يَضْحَك .<br>\
والجَزَلُ ، محرَّكةً : أن يَقطَعَ القَتَبُ غارِبَ البَعِيرِ ، وقد ) جَزَلَهُ يَجْزِلُه مِن حَدّ ضَرَب جَزْلاً بالفتح .<br>\
وأَجْزَلَهُ القَتَبُ كذلك .<br>\
أو الجَزَلُ : أن يُصِيبَ الغارِبَ دَبَرَةٌ فيَخرُجَ منه عَظْمٌ فيَتطامَنَ مَوضِعُه ، جَزِلَ ، كفَرِح ، فهو أَجْزَلُ ، وهي جَزْلاءُ قال أبو النَّجْم : يُغادِرُ الصَّمدَ كظَهْرِ الأَجْزَلِ جَزُلَ الحَطَبُ وغيرُه ككَرُمَ : عَظُمَ وغَلُظَ .<br>\
مِن المَجاز : جَزُلَ فُلانٌ : إذا صار ذا رأي جَيِّدٍ قَوِيٍّ مُحْكَم .<br>\
هذا زَمَنُ الجِزالِ ، بالفتح والكسر : أي صِرامِ النَّخْلِ قال :  ( حتَّى إذا ما حانَ مِن جِزالِها  وحَطَّتِ الجُرَّامُ مِن جِلالِها )  وجَزالَى ، كسَكَارَى : ع عن ابنِ دُرَيْدٍ .<br>\
والجَوْزَلُ كجَوْهَرٍ : الشابُّ رُبّما سُمِّيَ به .<br>\
الأَصلُ فيه فَرخُ الحَمامِ والجَمعُ : الجَوازِلُ ، يقال : عِندَ حَمامَةٌ بجَوازِلِها .<br>\
الجَوْزَلُ : السَّمُّ قال أبو عُبيدة : لم نسمعْ ذلك إلّا في قولِ ابنِ مُقْبِلٍ :  ( إذا المُلْوِياتُ بالمُسُوحِ لَقِينَها  سَقَتْهُنَّ كأساً مِن رَحِيقٍ وجَوْزَلا )  الجَوْزَلُ : ناقَةٌ تَقَعُ هُزالاً .<br>\
وبَنُو جَزِيلَةَ ، كسَفِينةٍ : بَطْنٌ مِن كِنْدَهَ وهو جَزِيْلَةُ بنُ لَخْم .<br>\
جُزَلٌ كصُرَدٍ : لَقَبُ سَعِيدِ بنِ<br>\
عُثمانَ يَحْتَمِلُ أن يكونَ الكرَيْزِيّ ، الذي حَدَّث بأصبَهانَ عن غُنْدَر ، أو البَلَوِيّ الذي حدَّث عن عاصِم بن أبي البَدَّاح ، فا نظُر ذلك .<br>\
وسَمَّوْا جَزْلاً وجَزْلَةَ بفتحهما .<br>\
وابنُ جَزْلَةَ : مُتَطَبِّبٌ .<br>\
ومما يُسْتَدْرَك عليه : الجَزْلُ ، بالفتح : مَوضِعٌ قُربَ مكّةَ ، حرسها اللّه تعالى .<br>\
وجَزَلَ الحَمامُ يَجْزِلُ : صاحَ .<br>\
والجَزِيلُ : العَظِيمُ .<br>\
وكَلامٌ جَزْلٌ : فَصِيحٌ جامِعٌ .<br>\
وجَزالَةُ الرأي : مَتانَتُه .<br>\
وأجْزَلَ عَطِيَّتَه ، وأجْزَل له في العَطاء : أي أكْثَر ، وهو مَجازٌ ، قال أبو النَّجْم : الحَمْدُ لِله الوَهُوبِ المُجْزِلِ أعْطَى فلَم يَبخَلْ ولم يُبَخّلِ واستَجْزَل رأْيَه في هذا : اسْتَجْوَدَه .<br>\
وهو جَزِلُ الرأي : فاسِدُه ، وقد تقدَّم .<br>\
وامرأةٌ جَزالاءُ ، بالمَدّ : أي جَزْلَةٌ نقلَه ابن دُرَيْد ، وقال : ليس بِثَبَتٍ .<br>\
وجُزُولَةُ ، بالضمّ : قَبِيلَةٌ مِن البَربَرِ ، سُمِّيَتْ بهم المدينةُ التي علَى شاطئ البَحر ، في أقْصَى المَغْرِب ، منهم الإمام أبو عبد الله مُحمّد بن سُليمان الجُزُولِيُّ ، مؤلِّفُ دَلائلِ الخَيرات ، تُوفي عامَ سبعين وثمانمائة .<br>\
وجَزِيلَةُ بنُ لَخْمٍ ، كسَفِينةٍ : بَطْنٌ ، )<br>\
هكهذا ضبطه ابنُ حَبِيب ، والوَزِير المَغْرِبي .<br>\
وقال قومٌ : هو جَدِيلَةُ ، بالدال ، قال ابن الجَوَّانيّ : والأولُ : الصَّوابُ ، وعليه العَمَلُ .<br>\
والأَجْزَلُ : مَوضِعٌ ، قاله نَصْرٌ ، وأنشد لقَيسِ بن الصَّرَّاع العِجْلِيّ :  ( سَقَى جَدَثاً بالأَجْزَلِ الفَردِ بالنَّقا  رِهامُ الغَوادِي مُزْنَةً فاسْتَهَلَّتِ )<br>\
' } );