load_data( { book: 'ta_nvd', text: '&lt;فرص&gt;فَرَصَهُ ، يَفْرِصُه : قَطَعَه ، و قِيلَ فَرَصَ الجِلْدَ : خَرَقَهُ وشَقَّهُ .<br>\
ومنه بَرَصْتُ النَّعْلَ ، أَي خَرَقْتُ أُذُنَيْهَا لِلشِّرَاكِ .<br>\
وقال اللَّيْثُ : الفَرْصُ : شَقُّ الجِلْد بحَدِيدَةٍ عَرِيضَة الطَّرَفِ تَفرِصُهُ بِهَا فَرْصاً ، كما يَفْرِصُ الحَذَّاءُ أُذُنَي النَّعْلِ عند عَقِبِهِما ، لِيَجْعَلَ فِيهِمَا الشِّرَاكَ ، وأَنْشَدَ : جَوادٌ حينَ يَفْرِصُهُ الفَرِيصُ يعني حِينَ يشق جلده العَرَقُ .<br>\
فَرَصَهُ : أَصَابَ فَرِيصَتَهُ .<br>\
وفي بَعْضِ نُسَخ الصّحاح : فَرِيصَهُ ، نَقَلَه الجَوْهَرِيّ ، قال : وَهُوَ مَقْتَلٌ .<br>\
والفَرْصُ : نَوَى المُقْلِ ، وَاحِدَتُه بهَاءٍ ، عن أَبي عَمْرٍ و .<br>\
والفَرْصَةُ : الرِّيحُ الَّتِي يُكُونُ مِنْهَا الحَدَبُ ، والسِّين فيه لُغَةٌ .<br>\
ومنه حَديثُ قَيْلَةَ : قد أَخَذَتْها الفَرْصَةُ .<br>\
قال أَبو عُبَيْدٍ : العَامَّة تَقُولُهُ الفَرْسَة ، بالسِّين ، والمَسْمُوع مِنَ العَرَب بالصَّاد ، وهي رِيحُ الحَدَبَة .<br>\
والفُرْصَةُ ، بالضّمّ : النَّوْبَةُ ، والشِّرْبُ ، نَقَلَهُ الجَوْهَرِيّ ، والسِّينُ لُغَة .<br>\
يُقَال : جَاءَت فُرْصَتُك من البِئْر ، أَي نَوْبَتُكَ ، وكذلِك الرُّفْصَةُ .<br>\
وقال يُعْقُوبُ : هي النَّوْبَةُ تَكُونُ بَيْنَ القَوْم يَتَنَاوَبُونَها على الماءِ في أَظْمائِهِم ، مثْل الخِمْسِ ، والرِّبْعِ ، والسِّدْسِ ، وما زادَ عَنْ ذلكَ ، والسِّينُ لُغَةٌ عَنْ ابْنِ الأَعْرَابِيّ .<br>\
وقال الأَصْمَعِيّ : يُقَال : إِذا جَاءَت فُرْصَتُك من البئْر فأَدْلِ .<br>\
وفُرْصَتُه : سَاعَتُهُ الَّتِي يَسْتَقِي فيها .<br>\
والمِفْرَصُ والمِفِرَاصُ : كمِنْبَرٍ ومِحْرَابٍ : الحَديدُ يُقْطَعُ به ، ونَصُّ ابنِ دُرَيْدِ : هُمَا اسْمُ حَدِيدة عَرِيَضَةٍ يُقْطَعُ بها الحَديدُ ، أَو الحَديدُ الَّذي يُقْطَعُ به الفِضَّةُ .<br>\
وهذا نَصُّ الجَوْهَرِيّ ، وزَادَ الزَّمَخْشَرِيّ : والذَّهَب .<br>\
وقال ابنُ دُرَيْدٍ : وقال قَوْمٌ : بَلْ هُوَ إِشْفىً عَريضُ الرَّأْسِ تُخْصَفُ به النِّعَالُ ، يَسْتَعْمِلُهُ الحَذَّاؤُونَ ، وأَنشَدُوا للأَعْشَى :  ( وأَدْفَعُ عن أَعْراضِكمْ وأُعِيرُكُمْ  لِسَاناً كمِفْرَاصِ الخَفَاجِيِّ مِلْحَبَا )  والفَرِيصُ : مَنْ يُفَارِصُكَ في الشُّرْبِ والنَّوْبَةِ ، كما في الصّحاح .<br>\
قال أَيضاً : الفَرِيصُ أَوْدَاجُ العُنُقِ ، والفَريصَةُ وَاحِدَتُهن عن أَبي عُبَيْد .<br>\
قال الأَصْمَعِيّ : ومنه الحَدِيثُ : إِنِّي لأَكْرَهُ أَنْ أَرَى الرَّجُلَ ثائراً فَرِيصُ رَقَبَتِه ، قائماً على مُرَيْئَته يَضْرِبُهَا .<br>\
وقال الجَوْهَرِيّ : كَأَنَّه أَرادَ عَصَبَ الرَّقَبَةِ وعُرُوقَها ، فإِنَّهَا هي الَّتي تَثُور عنْدَ الغَضَب .<br>\
قال الأَزْهَرِيُّ : وقِيلَ لابْن الأَعْرَابيّ : هل يَثُورُ الفَريصُ فقال : إِنَّما عَنَى شَعرَ الفَريص ، كما يُقَال : ثائرُ الرّأْس أَي ثائرُ شَعرِ الرَّأْسِ ، فاسْتَعارَها للرَّقَبَة وإِنْ لم تَكنْ لها فَرَائصُ ، لأَنّ الغَضَبَ يُثِيرُ عُرُوقَها ، والسِّين لُغَة فيه .<br>\
)<br>\
الفَريصَة : لَحْمَةٌ عند نُغْصِ الكَتِف ، وفي وَسَط الجَنْبِ ، عند مَنْبِضِ القَلْب ، وهُمَا فَرِيصتَانِ تَرْتَعدَانِ عند الفَزَعِ .<br>\
وقَال أَبو عُبَيْد : الفَرِيصَةُ : المُضْغَةُ القَلِيلَةُ تَكُونُ في الجَنْبِ تُرْعَدُ من الدّابّةِ إِذا فَزِعَتْ ، وجَمْعُهَا : فَرِيصٌ ، بغَيْرِ أَلِفِ .<br>\
وقال أَيضاً : هي اللَّحْمَةُ الَّتي بَيْن<br>\
َ الجَنْبِ والكَتِفِ ، الَّتِي لا تَزَالُ تُرْعَدُ .<br>\
وقَال غَيْرُه : هي المُضْغَةُ الَّتِي بَيْن الثَّدْيِ وَمَرْجِعِ الكَتِفِ مِن الرَّجُلِ والدَّابَّةِ .<br>\
وقيل : هي أَصْلُ مَرْجِعِ المِرْفَقَيْن .<br>\
الفَرِيصَةُ : أُمُّ سُوَيْدٍ ، أَي الاسْتُ ، عن ابْنِ دُرَيْد .<br>\
عن ابن الأَعْرَابِيّ : الفَرْصَاءُ : نَاقَةٌ تَقُومُ ناحِيَةً ، فإِذا خَلا الحَوْضُ جَاءَتْ وشَرِبَتْ .<br>\
قال الأَزْهَرِيّ : أُخِذَت من الفُرْصَة ، وهي النُّهْزَةُ .<br>\
قال ابن دُرَيْدٍ : فَرَّاصٌ ككَتّانٍ : أَبُو بَطْنٍ من بَاهِلَةَ .<br>\
قُلتُ : واسْمُهُ سِنَانٌ ، وهو ابْنُ مَعْنِ بنِ مَالِكِ بنِ أَعْصُرَ ، وهو مُنَبِّهٌ ، وإِخْوَتُهُ أَوْدٌ ، وجِئاوَة ، وزَيْدٌ ، ووَائِلٌ ، والحَارِثُ ، وحَرْبٌ ، وقُتَيْبَةُ وقَعْنَبٌ ، قاله ابنُ الكَلْبِيّ .<br>\
والفِرْصَةُ ، بالكَسْرِ : خِرْقَةٌ ، أَو قُطْنَةٌ ، أَو قِطْعَةُ صُوفٍ ، تَتَمَسَّحُ بِهَا المَرْأَةُ من الحَيْضِ .<br>\
وقال الأَصْمَعِيُّ : هي القِطْعَةُ من الصُّوفِ أو القُطْن ، أُخِذَ من فَرَصْتُ الشَّيْءَ ، أَي قَطَعْتُه .<br>\
ومنه الحَدِيثُ : خُذِي فِرْصَةً مُمَسَّكَةً فتَطَهَّرِي بِهَا أَي تَتَبَّعِي بها أَثَرَ الدَّمِ ، ج فِرَاصٌ ، عن ابْنِ دُرَيْدٍ ونَصُّه : يَقُولُون فِرَاصٌ ، كَأَنَّهُ جَمْعُ فِرْصَةٍ .<br>\
وأَفْرَصَتْهُ الفُرْصَةُ : أَمْكَنَتْهُ .<br>\
وافْتَرَصَهَا : انْتَهَزَها ، وقيلَ : اغْتَنَمَها .<br>\
وفي الأَساس : فُلانٌ لا يُفْتَرَصُ إِحْسَانُه وبِرُّه ، لأَنَّهُ لا يُخَافُ فَوْتُهُ .<br>\
قال الأُمَوِيُّ : الفِرَاصُ ، بالكَسْرِ : الشَّدِيدُ .<br>\
و قال الزِّيَادِيّ : هو الغَلِيظُ الأَحْمَرُ وأَنْشَدَ ابنُ بَرِّيٍّ لأَبِي النَّجْم : ولاَ بِذَاكَ الأَحْمَرِ الفِرَاص<br>\
فِرَاصٌ : جَدٌّ لعَمْرِو بْن أَحْمَرَ الشَّاعِرِ المُعَمَّرِ المُخَضْرَمِ ، ومات في عَهْدِ عُثْمَانَ ، رَضِيَ اللهُ عنهُ .<br>\
مُسْلِماً ، قَيَّدَهُ الشاطِبِيُّ في مُعْجَمِ المَرْزُبانِيّ بالتَّشْدِيدِ على الصَّوابِ ، هو عَمْرُو بنُ أَحْمَرَ بنِ العَمَرَّدِ بنِ عَمْرِو بنِ فَرّاصِ بنِ مَعْنٍ البَاهِلِيّ ، وهذَا هو الَّذِي قَالَ فِيهِ آنِفاً : إِنّه أَبُو بَطْنٍ من باهِلَة ، فلِذا لَوْ قَال هُناك : ومنهم عَمْرُو بنُ أَحْمَرَ الشَّاعرُ لَسَلِمَ من التَّكْرَار ، فتَأَمَّلْ .<br>\
قال الأُمَوِيّ : يُقَال : مَا عَلَيْهِ فِرَاصٌ ، أَي ثَوْبٌ .<br>\
وتَفْرِيصُ أَسْفَلِ النَّعْلِ نَعْلِ القِرَابِ : تَنْقِيشُهُ بطَرَفِ الحَدِيدِ ، كما في العُبَابِ .<br>\
والمُفَارَصَةُ : المُنَاوَبَةُ ، يُقَال : هو فَرِيصِي ومُفَارِصِي .<br>\
وتَفَارَصُوا بِئْرَهُم ، أَي تَنَاوَبُوها .<br>\
وممّا يُسْتَدْرَكُ عَلَيْه : الفُرْصَةُ ، بالضَّمِّ : النُّهْزَةُ ، وقد فَرَصَهَا فَرْصاً ، وتَفَرَّصَهَا : أَصابَهَا ، كافْتَرَصَها .<br>\
والفِرْصَةُ ، بالكَسْرِ ، والفَرِيصَةُ ، كِلاهُمَا عن يَعْقُوبَ بمَعْنَى النَّوْبَةِ تَكُونُ بَيْنَ القَوْمِ يَتَنَاوَبُونَها على الماءِ .<br>\
وفُرْصَةُ الفَرَسِ : سَجِيّتُه ، وسَبْقُه ، وقُوَّتُه قال : ) يَكْسُو الضَّوَى كُلَّ وَقَاحٍ مِنْكَبِ أَسْمَرَ في صُمِّ العَجَايَا مُكْرَبِ ياقٍ على فُرْصَتِهِ مُدَرَّبِ وافْتُرِصَتِ الوَرَقَةُ : أُرْعِدَتْ وفُرِص الرَّجُلُ ، كعُنِيَ ، فَرْصاً : شَكَا فَرِيصَتَهُ .<br>\
وافْتَرَصَ فُلاناً ظُلْماً : اقْتَطَعَهُ ، أَي تَمَكَّنَ بالوَقِيعَةِ في عِرْضِه ، وهو مَجاز .<br>\
وأَيَّامُك فُرَصٌ .<br>\
ويُقَالُ : بَيْنَ جَنْبَيْهِ مِفْرَاصُ الخَفَاجِيّ ، وهو مَجازٌ .<br>\
والفَرْصَةُ ، بالفَتْح ، والفُرْصَة ،<br>\
بالضَّمّ : لُغَتَان في الفِرْصَة ، بالكَسْر ، لِخِرْقَةٍ أَو قُطْنَةٍ ، عن كُرَاع .<br>\
والفِرْصَة ، بالكَسْرِ : قِطْعَةٌ من المسْك ، عن الفَارِسِيّ ، حَكَاهُ في البَصْرِيّات لَه .<br>\
وجاءَ في بَعْضِ الرِّوايَات : خُذِي فِرْصَةً مِن مِسْكٍ .<br>\
وحَكَى أَبو دَاوُود في رِوَايَةٍ عن بَعْضِهِم : فَرِصَة ، بالقَاف ، أَي شيئاً يَسِيراً مثل القَرْصَة بطَرَفِ الإِصْبَعَيْن .<br>\
وحَكَى بَعْضُهُم عن ابن قُتَيْبَةَ : قَرْضَة ، بالقَافِ والضَّادِ المُعْجَمَة ، أَي قِطْعَةً .<br>\
ومن المَجاز : هو ضَخْمُ الفَرِيصَةِ ، أَي جَرِيءٌ شَدِيدٌ .<br>\
وفَرَّاصٌ ، ككَتّان : مَوْضِعٌ في دِيَار سَعْدِ العَشِيرَةِ .<br>\
وككِتَابٍ : فِرَاصُ بْنُ عُتَيْبَةَ بنِ عَوْفِ بنِ ثَعْلَبَةَ : شَاعِرٌ جاهِلِيٌّ ، نَقَلَه الحَافِظ .<br>\
' } );