load_data( { book: 'ta_nvd', text: '&lt;مرش&gt;.<br>\
المَرْشُ : الخَدْش ، قال ابنُ السِّكِّيتِ : أَصابَهُ مَرْشٌ ، وهِيَ المُرُوشُ ، والخُدُوشُ ، والخُرُوشُ ، وفي حَدِيثِ غَزْوَةِ حُنَيْنٍ فعَدَلَتْ بِه نَاقَتُه إِلَى شَجَراتٍ فمَرَشْنَ ظَهْرَه أَيْ خَدَشَتْه أَغْصَانُها ، وأَثَّرَتْ في ظَهْرِه ، وأَصْلُ المَرْشِ : الحَكُّ بأَطْرَافِ الأَظَافِرِ ، وفي حَدِيثِ أَبِي مُوسَى إِذا حَكَّ أَحَدُكُمْ فَرْجَهُ وهُوَ في الصَّلاةِ فَلْيَمْرُشْه مِنْ وَراءِ الثّوْبِ قالَ الحَرّانِيّ : المَرْشُ بأَطْرَافِ الأَظَافِر ،<br>\
وقالَ ابنُ سِيدَه : المَرْشُ : شَقُّ الجِلْدِ بأَطْرَافِ الأَصَابِعِ وهُوَ أَضْعَفُ من الخَدْشِ ، ويُقَالُ : قد أَلْطَفَ مَرْشاً وخَرْشاً ، والخَرْشُ أَشَدُّه .<br>\
ومَرَشَه مَرْشاً : تَنَاوَلَه بأَطْرَافِ الأَصَابِع ، شَبِيهاً بالقَرْصِ .<br>\
والمَرْشُ : الأَرْضُ الَّتِي مَرَشَ المَطَرُ وَجْهَها ، يُقَال : انْتَهَيْنَا إِلى مَرْش من الأَمْرَاشِ .<br>\
نَقَلَهُ الجَوْهَرِيُّ ، وهو اسْمُ الأَرْضِ مَعَ الماءِ ، وبَعْدَ الماءِ إِذا أَثَّرَ فِيه .<br>\
وقَالَ ابنُ سِيدَه : المَرْشُ : أَرْضٌ يَمْرُشُ الماءُ من وَجْهِها في مَوَاضِعَ لا يَبْلُغ أَن يَحْفِرَ حَفْرَ السَّيْلِ ، والجَمْعُ أَمْرَاشٌ .<br>\
وقالَ غَيْرُهما : المَرْشُ : الأَرْضُ الَّتِي إِذا أُمْطِرَتْ سالَتْ سَرِيعاً ، أَيْ رَأَيْتَها كُلَّهَا تَسِيلُ .<br>\
وقالَ أَبُو حَنِيفَةَ : الأَمْرَاشُ : مَسَايِلُ لا تَجْرَحُ الأَرْضَ ولا تَخُدُّ فِيها ، تَجِئُ من أَرْض مُسْتَوِيَّة تَتْبَعُ ما تَوَطّأ مِنَ الأَرْضِ في غَيْرِ خَدٍّ ، وقَدْ يَجِئُ المَرْشُ مِنْ بُعْدٍ ، ويَجِئُ منْ قُرْبٍ .<br>\
وقَالَ النَّضْرُ : المَرْسُ والمَرْشُ : أَسْفَلُ الجَبَلِ وحَضِيضُه ، يَسِيلُ منه الماءُ فيَدِبُّ دَبِيباً ولا يَحْفِرُ ، وجَمْعُه أَمْرَاسٌ وأَمْرَاشٌ ، قالَ : وسَمِعْتُ أَبا مِحْجَنٍ الضِّبَابِيّ يَقُول : رأَيْتُ مَرْشاً مِنَ السَّيْلِ .<br>\
وهُوَ الماءُ الَّذِي يَجْرَحُ وَجْهَ )<br>\
الأَرْضِ جَرْحاً يَسِيراً .<br>\
والمَرْشُ : الإِيْذاءُ بالكَلامِ ، وقَدْ مَرَشَه ، عن ابنِ الأَعْرَابِيّ ، وقالَ ابنُ عَبّادٍ : مَرَشَه بِكَلامٍ ، إِذا تَنَاوَلَهُ بِقَبِيحٍ .<br>\
والمَرْشاءُ : العَقُورُ مِنْ كُلِّ الحَيَوانِ ، نَقَلَه الصّاغَانِيُّ .<br>\
والمَرْشَاءُ : الأَرْضُ الكَثِيرَةُ ضُرُوبِ العُشْبِ ، نَقَلَهُ الصّاغَانِيُّ أَيْضاً .<br>\
قلتُ وكَأَنّه مَقْلُوبُ الرَّمْشاءِ .<br>\
ويُقَال : لي عِنْدَه مُرَاشَةٌ ومُرَاطَةٌ ، بالضّمِ ، أَيْ حَقٌّ صَغِيرٌ .<br>\
وقالَ ابنُ الأَعْرَابِيِّ : الأَمْرَشُ : الشِّرِّيرُ ، أَي الكَثِيرُ .<br>\
الشّرِّ .<br>\
والأَرْمَشُ : الحَسَنُ الخُلُقِ .<br>\
والأَمْشَرُ : النَّشِيطُ .<br>\
والأَرْشَمُ : الشَّرِهُ .<br>\
والتَّمْرِيشُ : المَطَرُ القَلِيلُ الَّذِي لا يَخُدُّ وَجْهَ الأَرْضِ ، عَن ابنِ عَبّادٍ .<br>\
والامْتِرَاشُ : الانْتِزَاعُ والاخْتِلاسُ ، يُقَال : امْتَرَشْتُ الشَّيْءَ مِنْ يَدِه : أَي اخْتَلَسْتُه .<br>\
والامْتِراشُ : الاكْتِسَابُ ، والجَمْعُ ، عن ابنِ عبّادٍ ، يُقَالُ : هُوَ يَمْتَرِشُ لعِيَالهِ ، أَيْ يَكْتَسِبُ ويَقْتَرِفُ .<br>\
وامْتَرَشَ الشيءَ : جَمَعَهُ ، وهُو يَمْتَرِشُ الشَّيْءَ بَعْدَ الشَّيْءِ مِنْ ها هنا أَيْ يَجْمَعُه .<br>\
ومَرْشانَةُ : د ، بالأَنْدَلُسِ ، من كُورضةِ إِشْبِيلِيَة ، مِنْهَا أَبُو مُوسَى عَبْدُ الرّحْمنِ بنُ هِشَامِ بنِ جَهْوَر المَرْشَانِيُّ ، عَنْ مُحَمَّدِ بنِ الحَسَنِ الآجُرِّيّ ، ماتَ ببلده سنة .<br>\
وممّا يُسْتَدْرَك عَلَيْه : مَرَشَ الماءُ يَمْرُشُ : سالَ .<br>\
والمَرْشُ : حَضِيضُ الجَبَلِ .<br>\
ورَجُلٌ مَرّاشٌ ، ككَتّانٍ ، أَي كَسّابّ .<br>\
والمُمَرَّشُ ، كمُعَظَّمٍ : نَوْعٌ من الكَتّانِ ، وهذِه عن الصّاغَانِيّ .<br>\
ومَرَشٌ ، مُحَرَّكَةً : ناحِيَةٌ بالرُّومِ .<br>\
وأَمراشُ : رَوْضَةُ بدِيارِ العَرَبِ .<br>\
' } );