load_data( { book: 'ta_nvd', text: '&lt;مطط&gt;مَطَّهُ يَمُطُّه مَطّاً : مَدَّهُ ، ومنه حَدِيثُ سَعْدٍ : لا تَمُطُّوا بآمِين .<br>\
( و)مَطَّ الدَّلْوَ يَمُطُّه مَطّاً : جَذَبَهُ .<br>\
وقال اللَّحْيَانِيّ : مَطَّ بالدَّلْوِ مَطّاً : جَذَبَ .<br>\
ويُقَالُ : تَكَلَّمَ فَمَطَّ حَاجِبَيْه ، أَي مَدَّهُما .<br>\
ومِنَ المَجَازِ : مَطَّ حاجِبَيْهِ ، و مَطَّ خَدَّهُ ، إِذا تَكَبَّرَ ، كنَأَي بجَانِبِهِ ، وصَعَّرَ خَدَّهُ .<br>\
ومَطَّ أَصابِعَهُ : مَدَّهَا مُخَاطِباً بِها ، أَي كأَنَّهُ يُخَاطِبُ بِها .<br>\
والمَطِيطَةُ ، كسَفِينَةٍ : الماءُ الكَدِرُ الخاثِرُ يَبْقَى في أَسْفَلِ الحَوْضِ .<br>\
وقِيلَ : هِيَ الرَّدْغَةُ ، جَمْعُه مَطَائطُ .<br>\
وقال الأَصْمَعِيُّ : المَطِيطَةُ : الماءُ فيه الطينُ يَتَمَطَّطُ ، أَيْ يَتَلَزَّجُ ويَمْتَدُّ .<br>\
وفي حَدِيثِ أَبِي ذَرٍّ : إِنّا نَأْكُلُ الخَطائطَ ، ونَرِدُ المَطَائطَ .<br>\
وقال حُمَيْدٌ الأَرْقَطُ :  ( في مُجْلِبَاتِ الفِتَنِ الخَوَابِطِ  خَبْطَ النِّهَالِ سَمَلَ المَطَائطِ )  وهذا الرَّجَزُ وَقَعَ في الصّحاح : سَمَل المَطِيطِ ، كَذا وُجِدَ بِخَطِّهِ .<br>\
وقال الصّاغَانِيُّ : ولَيْسَ الرَّجَزُ لِحُمَيْدٍ : قُلْتُ : والصَّوَابُ أَنَّهُ له ، وأَوَّلُه : قَدْ وَجَدَ الحَجَّاج غَيْرَ قانِطِ ومُطَيْطَةُ ، كجُهَيْنَةٍ : ع ، نَقَلَهُ الصّاغَانِيّ .<br>\
وأَنْشَدَ لعِدِيّ بنِ الرِّقَاعِ :  ( وكَأَنَّ نَخْلاً في مُطَيْطَةَ نَابِتاً  بالكِمْعِ بَيْنَ قَرَارِهَا وحَجَاهَا )  والمَطَاطُ ، كسَحَابٍ : لَبَنُ الإِبِلِ الخَاثِرُ الحَامِضُ ، عن ابنِ عَبّادٍ ، وهو القَارِصُ ، سُمِّيَ به لأَنَّهُ يَتَمَطَّطُ ، أَيْ يَتَلَزَّجُ ويَمْتَدُّ .<br>\
والمُطَيْطَاءُ ، كحُمَيْرَاءَ : التَّبَخْتُرُ ، كما في الصّحاحِ .<br>\
وقال غَيْرُهُ : هو مَشْيُ التَّبَخْتُرِ .<br>\
قال الزَّمَخْشَرِيّ في الفائق : هو من المُصَغَّرِ الَّذِي لا مُكَبَّرَ لَهُ .<br>\
)<br>\
قال شَيْخُنَا : وقد عَقَدُوا لِمِثْلِهِ باباً ، كما في الغَرِيبِ المُصَنَّفِ وغَيْرِه ، ومِثْلُه الكُمَيْتُ والكُعَيْتُ وغَيْرُ ذلِكَ .<br>\
( و)المُطَيْطاءُ : مَدُّ اليَدَيْنِ في المَشْيِ ، كما في الصّحاحِ ، وقال في لحَدِيثِ : إِذا مَشَت أُمَّتِي المُطَيْطَاءَ ، وخَدَمَتْهُمْ فارِسُ والرُّومُ ، كانَ بَأْسُهُم بَيْنَهُم هذِه رِوَايَةُ أَبِي عُبَيْدٍ .<br>\
ورِوَايَةُ اللَّيْثِ : سَلَّط الله شِرَارَهَا عَلَى خِيَارها .<br>\
قُلْتُ : هكَذَا قَرَأْتُ هذا الحَدِيثَ في كِتابِ العِلَلِ ، للدَّارَقُطْنِيّ ، ويُقْصَرُ ، عَنْ كُرَاع ، ورُوِيَ بالوَجْهَيْنِ في المَعْنَيَيْنِ عن الأَصْمَعِي أَيْضاً ، كما في اللِّسَانِ ، كالمَطِيطاءِ ، بالفَتْحِ والمَدِّ .<br>\
ومن المَجازِ : التَّمْطِيطُ : الشَّتْمُ .<br>\
ويُقالُ : تَمَطَّطَ ، أَيْ تَمَدَّدَ ، وكَذلكَ تَمَطَّى ، وهو من مُحَوَّلِ التَّضْعِيفِ ، وأَصْلُهُ تَمَطَّطَ .<br>\
وقال الفَرّاءُ في قَوْلِهِ تَعالَى : ثُمَّ ذَهَبَ إِلى أَهْلِهِ يَتَمَطَّى قال : أَي يَتَبَخْتَرُ ، لأَنَّ الظَّهْرَ هو المَطَا ، فيَلْوِي ظَهْرُهُ تَبَخْتُراً .<br>\
قال : ونَزَلَتْ في أَبِي جَهْلٍ .<br>\
قلْتُ : فحِينَئذٍ مَحَلُّ ذِكْرِهِ المُعْتَلُّ ، كما سَيَأْتِي .<br>\
وقال أَبو عُبَيْدٍ : مَنْ ذَهَبَ بالتَّمَطِّي إِلى المَطِيطِ فإِنَّهُ يَذْهَبُ به مَذْهَبَ تَظَنَّيْتُ من الظَّنِّ ، وتَقَضَّيْتُ مِنَ التَّقَضُّضِ ، وكَذلِكَ التَّمَطِّي يُرِيدُ التَّمَطُّطَ .<br>\
قال الأَزْهَرِيّ : والمَطُّ ، والمَطْوُ ، والمَدُّ ، وَاحِدٌ .<br>\
ويُقَال : مَطَوْتُ ، ومَطَطْتُ بِمَعْنَى المَدِّ .<br>\
( و)تَمَطَّطَ في الكَلامِ ، لَوَّنَ فِيهِ ، نَقَلَه الصّاغَانِيّ .<br>\
ومَطْمَطَ الرَّجُلُ ، إِذا تَوَنَى في خَطِّهِ أَوْ كَلامهِ .<br>\
نَقَلَه الأَزْهَرِيُّ عن ابْنِ الأعْرَابِيّ .<br>\
وقالَ ابنُ دُرَيْدٍ : مَطْمَطَ في كَلامِه إِذا مَدَّهُ وطَوَّلَهُ .<br>\
وتَمَطْمَطَ الماءُ : إِذا خَثُرَ ، نَقَلَه الصّاغَانِيُّ .<br>\
وفي نَصِّ الأَصْمَعِيّ : تَمَطْمَطَ الماءُ : إِذا تَلَزَّجَ وامْتَدَّ .<br>\
وصَلاً مطَاطٌ ، ككِتَابٍ وغُرَابٍ ، ومُطَائطٌ ، بالضَّمِّ ، أَي مُمْتَدٌّ ، وأَنشد ثَعْلَبٌ :  ( أَعْدَدْتُ لِلْخَوْضِ إِذا ما نَضَبَا  بَكْرَةَ شِيزَى ، ومُطَاطاً سَلْهَبَا )  يجوز أَن يُعنَى بها صَلا البَعِيرِ ، وأَنْ يُعْنَى بِهَا البَعِير .<br>\
ومِمّا يُسْتَدْرَكُ عَليه : المَطُّ : سَعَةُ الخَطْوِ ، وقَدْ مَطَّ يَمُطُّ ومَطَّ خَطَّهُ وخَطْوَهُ : مَدَّهُ ووَسَّعَهُ .<br>\
والمَطَائِطُ : مَوَاضِعُ حُفَرِ قَوَائمِ الدَّوابّ في الأَرْضِ ، تَجْتَمِعُ فِيها الرِّداغُ ، قاله اللَّيْثُ : وأَنشد :  ( فَلَمْ يَبْقَ إِلاَّ نُطْفَةٌ في مَطِيطَةٍ  من الأَرْضِ فاسْتَقْصَيْنَها بالجَحافِل )  وقال ابْن الأَعْرَابِيّ : المُطُطُ ، بِضَمَّتَيْن : الطُّوَالُ مِن جَمِيعِ الحَيَوَانِ .<br>\
والمِطْمَاطُ ، بالكَسْرِ : مَوْضِعٌ بالمَغْرِبِ ، إِلَيْه نُسِبَ الإِمَامُ الفَقِيهُ أَبُو عَبْدِ اللهِ مُحَمّدُ بنُ أَبِي القاسِمِ -المِطْماطِيُّ ، مِمَّنْ أَخَذَ عنه الإِمَامُ أَبو عُثْمَانَ الجَزَائرِيّ ، عُرِفَ بقَدروةَ .<br>\
' } );