load_data( { book: 'ta_nvd', text: '&lt;معط&gt;مَعَطَهُ ، كَمَنَعه ، يَمْعَطَهُ مَعْطاً : مَدَّهُ ، نَقَلَهُ اللَّيْثُ ، لُغَةٌ في مَغَطَ ، بالغَيْنِ .<br>\
ومنه : مَعَطَ السَّيْفَ من قِرابِه ، إِذا سَلَّهُ ومَدَّهُ ، كامْتَعَطَهُ ، نَقَلَه الصّاغَانِيّ .<br>\
ومنه أَيْضاً : مَعَطَ في القَوْسِ ، إِذا نَزَعَ وأَغْرَقَ .<br>\
وفي حَدِيثِ أَبِي إِسْحَاقَ : إِنَّ وَهْرِزَ وَتَّرَ قَوْسَه ، ثُمَّ مَعَطَ فِيهَا ، حَتَّى إِذا مَلأَهَا أَرْسَلَ نُشَّابَتَهُ ، فأَصَابَتْ مَسْرُوقَ ابنَ أَبْرَهَةَ ، أَيْ مَدَّ يَدَيْهِ بِهَا .<br>\
والمَعْط : ضَرْبٌ من النِّكَاح .<br>\
يُقَالُ : مَعَطَ المَرْأَةَ ، أَيْ جَامَعَها ، قاله اللَّيْثُ .<br>\
ومَعَطَت النَّاقَةُ بِوَلَدهَا : رَمَتْ بِهِ ، نقله الصّاغَانِيّ .<br>\
ومَعَطَ الشَّعرَ مِنْ رأْسِ الشّاةِ مَعْطاً : نَتَفَهُ ، نقله اللَّيْثُ .<br>\
ومَعَطَ بِهَا : حَبَقَ .<br>\
ومَعَطَهُ بحَقِّه : مَطَلَ .<br>\
وأَبو مُعْطَةَ ، بالضَّمِّ : الذِّئْبُ ، لِتَمَعُّطِ شَعرِهِ ، عَلَمٌ مَعْرِفَةٌ ، وإِنْ لم يَخُصَّ الوَاحِدَ مِنْ جِنْسِهِ ، وكَذلِكَ أُسَامَةُ ، وذُؤَالَةُ ، وثُعَالَةُ ، وأَبُو جَعْدَةَ .<br>\
وأَبُو مُعَيْطٍ ، كزُبَيْرٍ ، اسْمُهُ أَبَانُ ابنُ أَبِي عَمْرِو بنِ أُمَيَّةَ بنِ عَبْدِ شَمْسِ بنِ عَبْدِ منافٍ القُرَشِيُّ الأُمَوِيُّ أَخُو مُسَافِرٍ وأَبِي وَجْزَةَ ، وهو وَالِدُ عُقْبَةَ ، وَبنُوهُ الوَلِيدُ ، وعُمَارَةُ ، وخالِدٌ إِخْوَةُ عُثْمَانَ بنِ عَفَّانَ لأُمِّهِ .<br>\
ومُعَيْطٌ : اسمٌ .<br>\
ومُعَيْطٌ : ع ، أَوْ هو كأَمِيرٍ ، الأَوّلُ ضَبْطُ الأَرْزَنِيِّ بخَطّهِ في الجَمْهَرَةِ ، والثَّانِي وُجِدَ بِخَطِّ أبِي سَهْلٍ الهَرَوِيِّ فيها .<br>\
قال الصّاغَانِيّ : وأَنا أَخْشَى أَنْ يَكُونَا تَصْحِيفَيْ مَعْيَطٍ ، كمَقْعَدٍ ، وقد تَقَدَّم .<br>\
ومُعَيْط : أَبُو حَيٍّ من قُرَيْشٍ ، منهم المُعَيْطِيُّ أَحَدُ أَئمَّةِ المَالِكِيَّةِ .<br>\
وَمعِطَ الذِّئْبُ ، كفَرِحَ : خَبُثَ ، أَوْ قَلَّ شَعُره ، ولا يُقَالُ ، مَعِطَ شَعرُهُ ، قاله اللَّيْثُ ، فهو أَمْعَطُ بَيِّنُ المَعَطِ ، ومَعِطٌ ، ككَتِفٍ .<br>\
وفي الصّحاح : الذِّئْبُ الأَمْعَطُ ، الَّذِي قَدْ تَساقَطَ شَعرُهُ ، وقد تَقَدَّمَ في<br>\
م ر ط أَنَّه تَساقَطَ شَعرُهُ وزادَ خُبْثُه .<br>\
وتَمَعَّطَ الرَّجُلُ وامَّعَطَ ، كافْتَعَلَ ، أَصْلُه امْتَعَطَ ، وفي الصّحاح : انْمَعَطَ كانْفَعَلَ ، أي تَمَرَّط وسَقَطَ عَلَى الأَرْضِ مِنْ داءٍ يَعْرِضُ لَهُ .<br>\
وتَمَعَّطَت أَوْبارُه ، أَي تَطايَرَت وتَفَرَّقَتْ .<br>\
والأَمْعَطُ من الرِّجَال : مَنْ لا شَعَرَ له على جَسَدِهِ ، كالأَمْرَطِ والأَجْرَدِ ، وقد مَعِطَ شعرُه وجِلْدُهُ .<br>\
يُقَالُ : رَجُلٌ أَمْعَطُ سَنُوطٌ .<br>\
ومن المجاز : الأَمْعَطُ : الرَّمْلُ لا نَبَاتَ فِيهِ ، وكذلِكَ أَرْضٌ مَعْطَاءُ ، ورَمْلَةٌ مَعْطَاءُ ورِمَالٌ مُعْطٌ ، بالضَّمِّ : لا نَبَاتَ بِهَا .<br>\
وأَمْعَاط : ع ، هكذا في سائر النُّسَخِ ، وصَوَابُه أَمْعَطُ ، كما في المُعْجَمِ والتَّكْمِلَةِ واللِّسَان ، وهو اسْمُ أَرْضٍ في قَوْل الرّاعي :  ( يَخْرُجْنَ باللَّيْلِ مِنْ نَقْعٍ له عُرُفٌ  بقَاعِ أَمْعَطَ بَيْنَ السَّهْلِ والصِّيَرِ )  ويُرْوَى : بَيْنَ الحَزْنِ والصِّيَرِ .<br>\
قال ياقُوت : ورَوَاهُ ثَعْلَبٌ بِكَسْرِ الهَمْزَةِ .<br>\
)<br>\
وامْتَعَطَ النَّهَارُ : ارْتَفَعَ وامْتَدَّ مثل امْتَغَطَ بِالْغَيْنِ ، كانْمَعَطَ كانَفَعَلَ .<br>\
وامَّعَطَ الحَبْلُ ، كافْتَعَل ، أَصْلُهُ امْتَعَطَ ، زادَ في الصّحاح وغَيْرِه : انْجَرَدَ ، وعَلَيْه اقْتَصَرَ الجَوْهَرِيّ .<br>\
وقال أَبُو تُرَابٍ : امَّعَطَ على انْفَعَل : إِذا طَالَ وامْتَدَّ ، مثلُ امَّغَطَ ، بِالْغَيْنِ ، ومنه المُمَّعِطُ بتَشْدِيدِ المِيمِ الثّانِيَةِ المَفْتُوحَةِ لِلْبَائِنِ الطُّولِ .<br>\
قال الأَزْهَرِيّ : المَعْرُوفُ في الطُّولِ المُمَّغِطُ ، بالغَيْنِ المُعْجَمَة ، وكَذلِكَ رَوَاهُ أَبُو عُبَيْدٍ عن الأَصْمَعِيّ ، قال : ولَمْ أَسْمَعْ مُمَّعِطاً بِهذَا المَعْنَى لِغَيْرِ اللَّيْث إلاّ ما قرَأْتُ في كتاب الاعْتِقَابِ لأَبِي تُرابٍ .<br>\
قَال : سمعتُ أَبا زَيْدٍ وفُلانَ بنَ عَبْدِ اللهِ<br>\
التَّمِيمِيّ يَقُولانِ : رَجُلٌ مُمَّعِطٌ ومَمَّغِطٌ ، أَي طَوِيلٌ .<br>\
قال الأَزْهَرِيّ : ولا أُبْعِدُ أَنْ يَكُونَا لُغَتَيْن ، كما قالُوا : لَعَنَّكَ ولَغَنَّك ، بِمَعْنَى لَعَلَّك ، والمَعَصُ والمَغَصُ من الإِبِلِ : البِيضُ .<br>\
وسُرُوعٌ وسُرُوغٌ ، للقُضْبَانِ الرَّخْصَةِ .<br>\
قال ابْنُ الأَعْرَابِيّ : المَعْطاءُ ، والشَّعْرَاء ، والدَّفْراءُ : من أَسْمَاءِ السَّوْأَة .<br>\
ومِمّا يُسْتَدْرَك عليه : المَعْطُ : الجَذْبُ .<br>\
وامْتَعَطَ رُمْحَهُ : انْتَزَعَهْ .<br>\
والأَمْعَطُ : المُمْتَدُّ على وَجْهِ الأَرْضِ .<br>\
والمَعْطَاءُ : الذِّئْبَةُ الخَبِيثَةُ .<br>\
وشَاةٌ مَعْطَاءُ : سَقَطَ صَوفُهَا .<br>\
ولِصٌّ أَمْعَطُ ، على التَّمْثِيلِ بالذِّئْبِ الأَمْعَطِ ، لخُبْثِهِ ، ولُصُوصٌ مُعْطٌ ، كما في الصّحاحِ .<br>\
زادَ في الأَسَاسِ : شُبِّهَتْ بالذِّئابِ المُعْطِ في خُبْثِهَا ، فوُصِفَتْ بِوَصْفِهَا .<br>\
والتَّمَعُّطُ في حُضْرِ الفَرَسِ : أَنْ يَمُدَّ ضَبْعَيْهِ حَتَّى لا يَجِدَ مَزِيداً ، ويَحْبِسَ رِجْلَيْهِ حَتَّى لا يَجِدَ مَزِيداً ، لِيَلْحَقَ ويَكُونَ ذلِكَ مِنْهُ في غَيْرِ الاحْتِلاط ، يَسْبَحُ بِيَدَيْهِ ويَضْرَحُ برِجْلَيْهِ في اجْتِماعِهِما كالسّابح .<br>\
والمُتَمَعِّط : المُتَسَخِّطُ والمُتَغَضِّبُ ، يُرْوَى ، بالْعَيْنِ وبِالْغَيْن ، قاله ابنُ الأَثِير .<br>\
وماعِط : اسمٌ .<br>\
ومَعِيطٌ ، كأَمِيرٍ : ابنُ مَخْزُومٍ القَيْسِيّ جَدّ حَيّانَ بن الحُصَيْنِ بنِ خُلَيفِ ابن رَبِيعَةَ الشّاعِر .<br>\
وابنُ عَمِّهِ ضُبَيْعَةُ ابنُ الحَارِثِ بن خُلَيفٍ شاعِرٌ أَيْضاً ، نَقَلَهُ الحَافِظُ .<br>\
' } );