load_data( { book: 'ta_nvd', text: '&lt;لحق&gt;لحِق به كسَمِع ، ولَحِقه لَحْقاً ولَحاقاً بفَتْحِهما : أدرَكَه .<br>\
ومنه الحَديث : أسرعُكُنّ لَحاقاً بي أطْوَلُكنّ يَداً ، وكذلك اللُّحوق بالضمِّ كألْحَقَه إلحاقاً وهذا لازِمٌ متَعدٍّ .<br>\
يُقال : ألحقَه به غيرُه ، وألحَقَه : أدْرَكَه .<br>\
قال ابنُ برّي : شاهِدُ اللازِم قولُ أبي دُواد :  ( فألحَقَه وهْوَ سَاطٍ بها  كما تُلْحِقُ القَوسُ سَهْمَ الغَرَبْ )  وفي دُعاءِ القُنوتِ : إنّ عذابَكَ بالكُفّار مُلْحِق بكَسْر الحاءِ أي : لاحِقٌ ، والفَتْح أحسَنُ ، أو هو الصّواب كما قاله الجوهريّ والصاغانيّ .<br>\
وقال ابنُ دُرَيْد : مُلحَق ومُلحِق جَميعاً .<br>\
وقال اللّيثُ : بالكَسْر أحبُّ إلينا ، قال : ويُقال : إنّها من القُرآن لم يَجدُوا عليها إلا شاهِداً واحداً فوضِعَتْ في القُنوت .<br>\
قال : وهذه اللّغَة موافقةٌ لقولِ الله تعالى : ) سُبحان الذي أسْرى بعَبْدِه ( .<br>\
وقال ابنُ الأثير :<br>\
الرِوايةُ بكسْرِ الحاءِ ، أي : مَنْ نَزَل به عذابُك ألحَقَه بالكُفّار ، وقيل : هو بمعنَى لاحِق ، لغةٌ في لَحِقٍ ، يُقال : لحِقْته وألحَقْته بمعنى ، كتَبِعْتُه وأتْبَعْته ، ويُروى بفَتْح الحاءِ على المَفْعول أي : إنّ عذابَك مُلْحَقٌ بالكُفّارِ ويُصابون به .<br>\
ولَحِقَ ، كسَمِع لُحوقاً بالضّمِّ ، أي : ضَمُر ، نقله الجوهريّ .<br>\
زاد الزمخشريُّ : ولَصِق بطنُه وهو مَجازٌ .<br>\
وقال الأزهريّ : فرسٌ لاحِقُ الأيْطَلِ ، من خيْلٍ لُحْقِ الأياطِل : إذا ضُمِّرَتْ .<br>\
وفي قَصيدة كعْبٍ رضي الله عنه :  ( تَخدِي على يَسَراتٍ وهي لاحِقَةٌ  ذوابِلٌ وقعُهُنّ الأرضَ تحليلُ )  وأنشد الصاغانيّ لرؤبَة : لواحِقُ الأقْرابِ فيها كالمَقَقْ ولاحِق : اسم أفْراس كانت لمُعاوِية بنِ أبي سُفْيان رضي الله عنه كما في الصّحاح .<br>\
ولاحِق الأكْبر لغَنيّ بنِ أعْصُر .<br>\
ولاحِق : فرَس للحازُوقِ الخارِجيّ .<br>\
قالت أختُه تَرثيه :  ( ومن يَغْنمِ العامَ الوشيلَ ولاحِقاً  وقَتْل حِزاق لم يَزل عاليَ الذِّكْرِ )  ولاحِق : فرس لعُيَيْنة بنِ الحارِث بنِ شهاب .<br>\
وقال أبو النّدى : لاحِقٌ الأصغَرُ لبَني أسَد .<br>\
قال النابغة الذُبْيانيّ :  ( فيهم بناتُ العَسْجَديِّ ولاحِقٍ  وُرْقاً مراكِلُها من المِضْمارِ )  وقال ابنُ الكَلْبي في أنساب الخيل ما نصّه : ولاحِق الأصْغَرُ : من بَناتِ اللاّحق الأكْبرِ ، ولها يَقول الكُمَيْت : )  ( نجائِبُ من آلِ الوَجيه ولاحقٍ  تُذكِّرنا أحقادَنا حين تصْهَلُ )<br>\
وأبو لاحِق : كُنْية البازي ، نقله الصاغانيّ .<br>\
وقال أبو حاتم : اللُّوَيْحِقُ : طائِر أغْبَر يَصيدُ الوَبْر واليَعاقِيبَ .<br>\
وقال اللّيثُ : المِلْحاقُ : النّاقَة لا تكادُ الإبِلُ تَفوقُها في السّيْر .<br>\
قال رؤبَة : فهي ضَروحُ الرّكْضِ مِلْحاقُ اللَّحَق والمُلْحَقُ : الدَّعِيُّ المُلصَقُ كما في الصّحاح ، وهو مجاز .<br>\
ومنه باب الإلْحاق في كُتُب التّصْريف .<br>\
واللِّحاق ككِتاب : غِلافُ القَوْس كما في العُباب ، ولم يضْبطُه بالكسْر ، فاحْتَمل أن يكونَ بالفَتْح أيضاً .<br>\
والألْحاقُ : مَواضِعُ من الوادِي ينضُبُ عنها الماءُ ، فيُلْقَى فيها البَذْر يُقال : قد زَرَعوا الألحاقَ الواحِدُ لَحَقٌ ، مُحرّكة قاله الكِسائيُّ .<br>\
وقال ابنُ الأعرابيّ : اللَّحَقُ : أن يزْرعَ القومُ في جانبِ الوادي .<br>\
ويُقال : استَلْحَق الرجلُ ، أي : زَرَعها ، أي : الألْحاق .<br>\
واستَلْحَقَ فُلانٌ فُلاناً : ادّعاه .<br>\
وفي حديث عَمْرو بنِ شُعَيْب : أنّ النبيّ صلّى الله عليه وسلم قَضَى أنّ كُلَّ مُسْتَلْحَق استُلحِق بعدَ أبيه الذي يُدْعى له فقد لحِق بمَنْ استَلْحَقَه ، قال ابنُ الأثير : قال الخَطّابيّ : هذه أحكامٌ وقَعت في أوّل زَمانِ الشّريعةِ وذلك أنّه كان لأهْلِ الجاهليّةِ إماءٌ بغايا ، وكان سادَتُهنّ يُلِمّون بهِنّ ، فإذا جاءَت إحداهُنّ بولَد رُبّما ادّعاه السّيّد والزاني ، فألْحَقَه النبيُّ صلّى الله عليه وسلم بالسَّيِّد لأنّ الأمةَ فِراشٌ كالحُرّة ، فإن مات السّيِّدُ ولم يسْتَلْحِقْه ، ثم استَلْحَقَه ورثَتُه بعده ، لحِقَ بأبيه ، وفي مِيراثِه خِلافٌ .<br>\
واللَّحَقُ مُحرّكةً : شيءٌ يُلحَق بالأوّل كما في الصحاح .<br>\
واللَّحَق من التّمْر : الذي<br>\
يُلْحَقُ .<br>\
وفي الصِّحاح : يأتي بعْدَ الأوّل ، زادَ أبو حَنيفَةَ : وكُلُّ ثَمَرة تجيءُ بعدَ ثَمَرةٍ فهي لَحَقٌ ، والجمْع ألْحاقٌ .<br>\
وقال الليْثُ : اللَّحَقُ : كُلّ شيءٍ لحِقَ شيئاً أو لُحِّقَ به من الحَيَوان والنّبات وحَمْلِ النخلِ .<br>\
وقيل : اللَّحَق في النّخْل أن يُرطِبَ ويُتَمِّرَ ، ثم يَخْرُج في بطْنِه شيءٌ يكون أخْضَر ، قلّما يُرطِب حتى يُدرِكَه الشّتاءُ فيُسقِطَه المَطَرُ ، وقد يكون نحْو ذلك في الكَرْم يُسمّى لَحَقاً .<br>\
وقد قال الطِّرِمّاحُ في مثل ذلك يصِفُ نخْلةً أطْلَعَتْ بعدَ ينْعِ ما كان خرجَ منها في وقْتِه ، فقال :  ( ألحَقَتْ ما استَلْعَبَت بالّذي  قد أنَى إذْ حانَ حينُ الصِّرامْ )  أيْ ألحَقت طَلْعاً غَريضاً كأنّها لعِبت به إذْ أطْلَعَتْه في غيرِ حِينِه ، وذلك أنّ النّخلَة إنّما تُطلِعُ في الرّبيع ، فإذا أخرَجَت في آخرِ الصّيف ما لا يكون له يَنْع ، فكأنّها غيرُ جادَّةٍ فيما أطْلَعَت .<br>\
وتَلاحَقَت الرِّكابُ والمَطايا أي : لحِقَ بعضُها بعْضاً ، قال الشاعر : )  ( أقولُ وقد تلاحَقَتِ المَطايا  كَفاكَ القَوْلُ إنّ عليكَ عيْنا )  أي : ارفُق وأمْسِكْ عن القوْلِ .<br>\
ومما يُسْتَدْرَكُ عليه : اللُّحُوق ، بالضّمِّ : اللّزوم واللّصوق .<br>\
وألحقَ فُلانٌ فلاناً وألحقَه : كلاهما جعله مُلحقَه .<br>\
وتَلاحقَ القومُ : أدركَ بعضُهم بعضاً .<br>\
واللَّحَق ، مُحرّكة : ما يُلْحَقُ بالكِتاب بعد الفَراغِ منه ، فيُلْحَق به ما سَقَط عنه ، ويُجمعُ ألْحاقاً ، وإن خُفِّفَ فقيل : لَحْقٌ كان جائِزاً ، نقله الأزهريّ .<br>\
قلت : وقولُهم : لِحاقٌ لذلك بالكسرِ غلَط ، ويُسَمُّون ما لحق به مُلْحَقه .<br>\
واللَّحَقُ أيضاً : الشيءُ الزائِدُ .<br>\
قال ابنُ عُيَيْنة : كأنّه بيْنَ أسْطُرٍ لَحَقُ واللّحَق من النّاسِ : قوْم يَلْحَقون بقَومٍ بعدَ مُضيِّهم ، قال الراجِزُ : ولَحَقٍ يَلْحَق من أعْرابِها قال الأزهريّ : يجوزُ أن يكون مصدراً لِلَحِقَ ، ويجوزُ أن يكون جَمْعاً للاحِق ، كما يُقال : خادِمٌ وخَدَمٌ ، وعاسٌّ وعَسَسٌ .<br>\
ولَحَقُ الغَنَمِ : أولادُها التي كادَت تلْحَق بها .<br>\
واللَّحَق : الزّرعُ العِذْي ، وهو ما سَقَتْه السّماءُ ، والجمعُ ألْحاقٌ .<br>\
وقوسٌ لُحُقٌ بضمّتَيْن ومِلْحاق : سَريعة السّهمِ ، لا تُريدُ شيئاً إلا لَحِقَته .<br>\
وألحَقَ الشّجَرُ : طلَع له اللَّحَق ، عن أبي حَنيفة .<br>\
واللَّحَق : رأسُ الجَبَل .<br>\
والدّعيُّ المُلصقَ بغيرِ أبيه عن اللّيث ، وهو المُلْحَق أيضاً عن الأزهريّ .<br>\
وألْحَقْتُهم : إذا تقدّمْتهُم ، قال ابنُ دُريْد : وليس بثَبت .<br>\
وقولُهم : التحقَ به ، أي : لحِق مُولَّدة .<br>\
قال الصّاغاني : لم أجِدْه فيما دُوِّن من كُتُب اللّغة ، فليُجْتَنَب ذلك ، وكذلك المَلاحق ، واللِّحاق ، ككِتاب .<br>\
وقولُهم : اللُّحوقِيّ بالضّم لشَبْه القارُورة .<br>\
وتَلاحَقَت الأخْبارُ : تتابَعَت ، وكذا أحوالُ القَوْم ، وهو مَجازٌ .<br>\
واللاحِقَةُ : الثّمَرُ بعدَ الثّمر الأول ، والجمع لَواحِق .<br>\
وأبو مِجْلَز ، لاحِقُ بنُ حُمَيد السّدوسيّ : تابِعيّ .<br>\
' } );