load_data( { book: 'ta_nvd', text: '&lt;لعع&gt;اللُّعَاعُ ، كغُرَابٍ : نَبْتٌ ناعِمٌ في أوَّلِ ما يَبْدُو ، كمَا في الصِّحاحِ زادَ غَيْرُه : رَقيقٌ ، ثُمَّ يَغْلُظُ ، واحِدَتُه لُعاعَة ، وقالَ اللِّحْيَانِيِّ أكْثَرُ ما يُقَالُ ذلكَ في البُهْمَى ، وقالَ سُوَيْدُ بنُ كُراع ، يَصفُ ثَوْراً وكِلاباً :  ( رَعى غَيْرَ مَذْعُورٍ بهنَّ وَرَاقَهُ  لُعَاعٌ تَهاداهُ الدِّكادِكُ واعِدُ )  وأنْشَدَ الجَوْهَرِيُّ لابنِ مُقْبِلٍ ويُرْوَى لجِرانِ العَوْدِ ، ويُرْوَى للحَكَمِ الخُضْرِيِّ أيْضاً :  ( كادَ اللُّعَاعُ مِنَ الحَوذانِ يَسْحَطُهَا  ورِجْرِجٌ بَيْنَ لحْيَيْهَا خَناطِيلُ )  وقَدْ مَرَّ شَرْحُ هذا البَيْتِ في رجج فراجِعْهُ .<br>\
(و)اللُّعَاعَةُ بهاءٍ : الهِنْدَباءُ عن ابنُ الأعْرَابِيّ .<br>\
وقالَ ابنُ عَبّادٍ : اللُّعَاعَةُ الخِصْبُ و في الصِّحاحِ قالَ الأصْمَعِيُّ : ومِنْهُ ، أي : من اللُّعَاعِ بمَعْنَى النَّبْتِ النّاعِم ، قِيلَ : الدُّنْيا لُعاعَة ، وفي الحدِيثِ : إنَّمَا الدُّنْيا لُعاعَة يعنِي كالنَّباتِ الأخْضَرِ قَلِيلِ البَقَاءِ .<br>\
وقالَ المُؤَرِّجُ : اللُّعَاعَةُ : الجَرْعَةُ منَ الشَّرابِ ، يُقَالُ في الإناءِ لُعاعَة ، وقالَ غَيْرُه : هو ما بَقِيَ في السِّقاءِ ، وقيلَ : لُعاعَةُ الإناءِ : صَفْوَتَهُ ، وقالَ اللِّحْيَانِيِّ في الإناءِ لُعاعَةٌ ، أي : قَليلٌ .<br>\
وقالَ أبو عَمْروٍ : اللُّعَاعَةُ الكَلأُ الخَفِيفُ ، رُعِيَ أو لَمْ يُرْعَ وقالَ غَيْرُه : يُقَالُ في الأرْضِ لُعاعَةٌ : للشَّيءِ الرَّقِيقِ .<br>\
وألَعَّتِ الأرْضُ إلْعاعاً : أنْبَتَتْهَا .<br>\
وتَلَعَّى : تَنَاوَلَها ، كما في الصِّحاحِ ، قالَ : وأصْلُه : تَلَعَّعَ ، فكَرِهُوا ثلاثَ عَيْناتٍ ، فأبْدَلُوا مِنَ الأخيرَةِ ياءً ، وهُوَ منْ مَحَوَّلِ التَّضْعِيفِ ، وقالَ أبو مُحَمَّدِ بنُ السِّيدِ : حُكِيَ عنِ العَرَبِ : خَرَجْنَا لنَتَلَعَّى ، أيْ : نَرْعَى اللُّعَاعَ ، وقالَ ابنُ جِنِّي : أخْبَرَنا أبو عليٍّ بإسْنَادِه ليَعْقُوبَ قالَ : قالَ ابنُ الأعْرابِيِّ : تَلَعَّيْتُ من اللُّعَاعَةِ ، وهِيَ بَقْلَةٌ ، والأصْلُ : تَلَعَّعْتُ ، ثم أُبْدِلَ ، كتَظَنَّيْتُ ونَحْوِه .<br>\
واللَّعْلَعُ : السَّرَابُ نَقَلَه اللَّيْثُ .<br>\
(و)لَعْلَعٌ ، بلا لامٍ : جَبَلٌ كانَتْ بهِ وَقْعَةٌ ، كما في الصِّحاحِ والأساسِ ، يُذَكَّرُ ويُؤَنَّثُ ، ومنه الحَدِيثُ : ما أقامَتْ لَعلَعُ قالَ ابنُ الأثِيرِ : هو جَبَلٌ ، وأنَّثَهُ لأنَّه جَعَلَهُ اسْماً للْبُقْعَةِ الّتِي حَوْلَ الجَبَلِ ، وأنْشَدَ )<br>\
الجَوْهَرِيُّ لشّاعِرٍ وهُوَ عَمْرُو بن عَبْدِ الجِنِّ التَّنُوخِيُّ ، ونَسَبَهُ في اللِّسَانِ لِحُمَيدِ بنِ ثَوْرٍ :  ( لَقَدْ ذاقَ منّا عامِرٌ يَوْمَ لَعْلَعٍ  حُساماً إذا ما هُزَّ بالكَفِّ صَمَّمَا )<br>\
وقيلَ : لَعْلَعٌ : ع بَيْنَ البَصْرَةِ والكُوفَةِ .<br>\
وقالَ الأزْهَرِيُّ : لَعْلَعٌ ماءٌ بالبادِيَةِ وقدْ وَرَدْتُه ، قالَ الأخْطَلُ :  ( سَقَى لَعْلَعاً والقَرْيَتَيْن فلَمْ يَكَدْ  بأثْقَالِه عنْ لَعْلَعٍ يَتَحَمَّلُ )  وقال رُؤْبَةُ : أقْفَرَ منْ أُمِّ اليَمَانِي لَعْلَعُ فبَطْنُ ذِي قارٍ فقارٌ بَلْقَعُ وقالَ ابنُ عَبّادٍ : اللَّعْلَعُ : الذِّئْبُ وهو قَوْلُ ابنُ الأعْرَابِيّ وأنْشَدَ : واللَّعْلَعُ المُهْتَبِلُ العَسُوسُ قيلَ : سُمِّيَ بهِ لضَجَرِهِ منْ كُلِّ شَيءٍ .<br>\
واللَّعْلَعُ : شَجَرٌ حِجَازِيٌّ ، عن ابنِ عَبّادٍ .<br>\
واللَّعْلاعُ : الجَبَانُ ، عن المُؤَرِّجِ .<br>\
واللَّعَّةُ : المَرْأةُ العَفِيفَةُ المَلِيحَةُ ، قالَهُ اللّيْثُ ، ومِثْلُه في الرَّوْضِ للسُّهَيْلِيِّ ، وقِيلَ : هِيَ الخَفِيفَةُ تُغَازِلُكَ ولمْ تُمَكِّنْكَ ، وقالَ اللِّحْيَانِيِّ هِيَ المَلِيحَةُ الّتِي تُدِيمُ نَظَرَكَ إليْهَا مِنْ جَمالِهَا .<br>\
قالَ اللَّيْثُ : واللَّعّاعَةُ ، مُشَدَّدَةً : مَنْ يَتَكَلَّفُ الألْحَانَ مِنْ غَيْرِ صَوابٍ ، كذا نَصُّ العَيْنِ والعُبَابِ ، وفي المُحْكَمِ : بلا صَوْتٍ .<br>\
ولَعْ : ولَعْلَعْ كِلاهُمَا : بمَعْنَى لعاً يُقَالُ للعاثِرِ ، كما في المُحِيطِ .<br>\
وتَلَعْلَعْتُ بهِ : قُلْتُ لَهُ ذلكَ نصُّ المُحِيطِ : لَعْلَعْتُ بهِ .<br>\
وتَلَعَّى : تَنَاوَلَ اللُّعَاعَ مِنَ الكَلأ ، هكذا في سائِرِ النُّسَخِ ، وهُوَ مُكَرَّرٌ .<br>\
مع ما سَبقَ لهُ .<br>\
وتَلَعْلَعَ عَظْمُه : تَكَسَّرَ مُطَاوِعُ<br>\
لَعْلَعَهُ ، كما في الصِّحاحِ وقالَ رُؤْبَةُ : ومَنْ هَمَزْنا رَأسَه تَلَعْلَعَا  (و)تَلَعْلَعَ منَ الجُوعِ : تَضَوَّرَ وتَحَزَّنَ .<br>\
وقِيلَ : تَلَعْلَعَ اضْطَرَبَ .<br>\
وتَلَعْلَعَ الكَلْبُ : أدْلَعَ لِسانَه عَطَشاً قالَ اللَّيْثُ : وإدْلاعُه ، تَلأْلُؤُهُ .<br>\
)<br>\
(و)تَلَعْلَعَ السَّرابُ : تَلألأ .<br>\
وتَلَعْلَعَ الرَّجُلُ : ضَعُفَ مِنْ مَرَضٍ أو تَعَبٍ ، عن ابنِ دُرَيدٍ .<br>\
ويُقَالُ عَسَلٌ مُتَلَعْلِعٌ ، ومُتَلَعٍّ والأصْلُ : مُتَلَعِّعٌ ، وهوَ : الّذِي يَمْتَدُّ إذا رُفِعَ فَلمْ يَنْقَطِعْ للُزُوجَتهِ .<br>\
واللَّعِيعَةُ : خُبْزُ الجاوَرْسِ نَقَله الجَوْهَرِيُّ .<br>\
واللَّعْلَعَةُ : كَسْرُ العَظْمِ ونَحْوِه يُقَالُ لَعْلَعَهُ فَتلَعْلَعَ ، نَقَله الجَوْهَرِيُّ .<br>\
(و)اللَّعْلَعَةُ منَ السَّرَابِ : بَصِيصُهُ .<br>\
وقالَ ابنُ عَبّادٍ : التَّحَزُّنُ منَ الجُوعِ ، والضَّجَرُ منْ كُلِّ شيءٍ ، وبه سُمِّيَ الذِّئبُ لَعْلعاً .<br>\
وممّا يُسْتَدْرَكُ عليه : اللُّعاعَةُ بالضَّمِّ البَقِيَّةُ اليَسِيرَةُ منْ كُلِّ شيءٍ ، ومنه قَوْلُهُم : ما بَقِيَ في الدُّنْيَا إلاّ لُعَاعَةٌ .<br>\
واللُّعَاعَةُ : كُلُّ نَباتٍ لَيِّنٍ من أحْرَارِ البُقُولِ فيهِ ماءٌ كَثِيرٌ لَزِجٌ ، ويُقَالُ لَهُ : النُّعَاعَةُ أيْضاً .<br>\
ولُعَاعُ الشَّمْسِ : السَّرَابُ ، والأكْثَرُ لُعابُ الشَّمْسِ .<br>\
والتَّلَعْلُعُ : التَّلألُؤُ .<br>\
ولَعْ لَعْ : زَجْرٌ ، حَكَاهُ يَعْقُوبُ في المُبْدَلِ ، وقد ذكَرَ المُصَنِّف مَقْلُوبَه علع في العَيْنِ .<br>\
وقالَ ابنُ عَبّادٍ : تَلَعْلَعَتِ الإبِلُ في كلإٍ ضَعِيفٍ ، أي : تتَبَّعَتْ .<br>\
وتَلَعْلَعَ من العَطَشِ : تَضَوَّرَ .<br>\
' } );