load_data( { book: 'ta_nvd', text: '&lt;بزل&gt;بَزَلَهُ يَبْزُلُه بَزْلاً وَبَزَّلَهُ تَبْزِيلاً : شَقَّه ، فَتَبَزَّلَ تَشَقَّق ، قال زُهَير بن أبي سُلْمَى :  ( سَعَى سَاعِيَا غَيظِ بنِ مُرَّةَ بعدَما  تَبَزَّلَ ما بَين العَشِيرَةِ بالدَّمِ )  وانْبَزَلَ كذلكَ ، يُقال : انْبَزَل الطَّلْعُ : أي انْشَقَّ .<br>\
قال ابنُ دُرَيْدٍ : بَزَلَ الخَمْرَ وغَيرَها : إذا ثَقَبَ إناءها واستَخْرَجها .<br>\
وقال غيرُه : كابْتَزَلَها وتَبَزَّلَها يُقال : ابْتَزَلْتُ الشَّرابَ لنَفْسِي .<br>\
وأنشدَ اللَّيثُ : تَحَدَّرَ مِن نَواطِبِ ذي ابْتِزالِ<br>\
ورواية الأزهريّ : تَحَدُّرُ ذي نَواطِبِ وابْتِزالِ وعَزاه لابن الأعرابي .<br>\
اسمُ ذلك المَوْضِعِ : بُزالٌ بالضَّمّ ، قال ابنُ دُرَيْدٍ : البُزالُ : المَوْضِعُ الذي يخرُج منه الشيء المَبزُولُ .<br>\
بَزَل الشَّرابَ : صَفَّاه كابْتَزَله ، وقال الأزهريُّ : لا أعرِفُ البَزْلَ بمَعْنى التَّصْفِية .<br>\
من المَجاز : بَزَل الأَمْرَ أو الرَّأي أي قَطَعَه واسْتَحْكَمه .<br>\
وأَمْرٌ بازِلٌ ، ورَأيٌ بازِلٌ : مُسْتَحْكِمٌ .<br>\
بَزَل نابُ البَعيرِ ، بَزْلاً وبُزُولاً فَطَر ، وطَلَع ومنه : جَمَلٌ وناقَةٌ بازِلٌ وبَزُولٌ للذَّكر والأُنثى ، عن ابن دُرَيْد .<br>\
وقال شيخُنا : وكان أبو زيدٍ يقول : لا تكون الناقَةُ بازِلاٌ ، ولكن إذا أَتَى عليها حَوْلٌ بعدَ البُزولِ ، فهي بَزُولٌ ، إلى أن تُنِيبَ ، فتُدْعَى عند ذلك : ناباً .<br>\
وفي الحديث : وأَرْبَعٌ وثلاثون ، ما بَيْنَ ثَنِيَّةٍ إلى بازِلِ عامِها .<br>\
كُلُّها خَلِفَةٌ .<br>\
والضمير في عامها يَرجِعُ إلى مَوصُوفٍ محذوف ، لأن التقدير : إلى ناقةٍ بازِلٍ عامُها ، ولا يجوز رجوعُه إلى بازِلٍ نفسِها .<br>\
ج : بُزَّلٌ ، كرُكَّع ، وكُتُبٍ ، وبَوازِلُ فيه لَفُّ وَنَشْرٌ مُرَتَّبٌ .<br>\
وذلك في تاسِعِ سِنِيه ورُبَّما بَزَل في الثانية .<br>\
قال ابنُ الأعرابيّ : وليس بعدَه سِنٌّ تُسَمَّى .<br>\
والبازِلُ أيضاً : السِّنّ تَطْلُع في وَقْتِ البُزُولِ قال ابنُ دُرَيْد : يقولون : كان ذلك عندَ بُزُولِه ، وعندَ بَزْلِه .<br>\
الجَمعُ : بَوازِلُ عن ابن الأعرابيّ .<br>\
قال النابِغَةُ ، في السِّنِّ ، وسَمّاه بازِلاً :  ( مَقْذُوفَةٍ بدَخِيسِ النَحْضِ بازِلُها  له صرِيفٌ صرِيفُ القَعْوِ بالمَسَدِ )  من المَجاز : البازِلُ : الرجُلُ الكامِلُ في تَجْرِبَتِه وعَقلِه .<br>\
وقال ابنُ دُرَيْد : رَجُلٌ بازِلٌ : إذا احْتَنَكَ ، ) تَشْبِيهاً بالبَعيرِ البازِلِ .<br>\
وفي حديث علي رضي اللّه تَعالَى عنه : بازِلُ عامَيْنِ حَدِيثٌ سِنِّي أي : أنا في استِكمالِ القُوّة ، كهذا البَعير ، مع حَداثةِ السِّنِّ .<br>\
وقال شيخُنا : وقولُهم : بازِلُ عامٍ ، وبازِلُ عامَيْنِ : إذا مَضَى له بعدَ البزُولِ عامٌ أو عامان .<br>\
والمِبْزَلَةُ والمِبْزَلُ : كمِكْنَسَةٍ ومِنْبَرٍ : المِصْفاةُ يُصَفَّى بها الشَّرابُ .<br>\
من المَجاز : خُطَّةٌ بَزْلاءُ : عَظِيمةٌ تَفْصِلُ بينَ الحَقِّ والباطِلِ .<br>\
من المَجاز : البَزْلاءُ : الدَّاهِيَةُ العظيمَةُ عن ابنِ دُرَيْدٍ .<br>\
وأيضاً : الرَّأي الجَيِّدُ قال الراعِي :  ( في صَدرِ ذي بَدَواتٍ ما تَزالُ لَهُ  بَزْلاءُ يَعْيَا بِها الجَثَّامَةُ اللُّبَدُ )  وأيضاً : الشَّدائِدُ قال ابنُ دُرَيْدٍ : يقولون : هو نَهَّاضٌ ببَزْلاءَ : إذا كان يقومُ بالأُمُورِ العِظامِ مُطِيقاً للشَّدائدِ ، ضابِطاً لها ، وأنشد الجوهريُّ :  ( إني إذا شَغَلَتْ قوماً فُروجُهُمُ  رَحْبُ المَسالِكِ نَهَّاضٌ ببَزْلاءِ )  من المَجاز : قولُهم : ما بَقِيتْ عندَه بازِلَةٌ ، كما يُقال : ما بَقِيتْ لهم ثاغِيَةٌ ولا راغِيَةٌ : أي واحِدةٌ ، وقال يعقوبُ : ما عِندَه بازِلَةٌ : أي : ليس عِندَه شيءٌ مِن مالٍ ولا تَركَ اللَّهُ عنده بازِلَةً ، ولم يُعْطِهم بازِلَةً : أي شيئاً .<br>\
وقال الزمخشري : ما عِندَه بازِلَةٌ :<br>\
أي بُلْغَةٌ تَبْزُل حاجتَه ، أي تقْضِيها .<br>\
وبُزْلٌ ، كقُفْلٍ : عَنْزٌ قال عُرْوَةُ بن الوَرْد :  ( أَلمَّا أَغْزَرَتْ في العُسِّ بُزْلٌ  ودِرْعَةُ بِنْتُها نَسِيَا فَعالِي )  بُزَيْلٌ كزُبَيرٍ : مَوْلَى العاصِ بن وائلٍ صاحبُ الجام ، مات بالسفر ، وأوصَى إلى تَمِيمٍ الدارِيّ .<br>\
البِزالُ ككِتابٍ : حَدِيدَةٌ يُفْتَحُ بها مَبزَلُ الدَّنِّ نقلَه الصاغانيُّ .<br>\
في النَّوادِر : رَجُلٌ تِبْزِلَةٌ ، بالكسرِ ، وتِبْزِيلَةٌ بزِيادة الياء ، وفي العُباب تُبَيْزِلَةٌ ، مُصغَّرا وتِبزِلَّةٌ مُشدَّدةً أي مع كسرِ أَوَّلِه : قَصِيرٌ .<br>\
والبازِلَةُ : الحارِصَةٌ مِن الشِّجاجِ وهي المُتلاحِمَةُ ، سُمِّيتْ لأنها تَبْزُلُ الجِلْدَ : أي تَشُقُّه ولا تَعْدُوه ومنه حديثُ زيدِ بن ثابت رضي اللّه تعالَى عنه : أنه قَضَى في البازِلَةِ بِثلاثةِ أبْعِرَةٍ .<br>\
وأمْرٌ ذو بَزْلٍ .<br>\
أي ذو شِدَّةٍ قال عمرو بن شَأس :  ( يُفَلِّقْنَ رأسَ الكَوكَبِ الفَخْمِ بَعدَما  تَدورُ رَحَى المَلْحاءِ في الأمرِ ذي البَزْلِ )  ومما يستدرك عليه : بُلِيَ بأشْهَبَ بازِلٍ : أي رُمِيَ بأمْرٍ صَعْبٍ شديدٍ .<br>\
والبَزِيلُ : الشَّرابُ المُبْتَزَلُ ، عن ابنِ عَبّاد .<br>\
قال : وشَجَّةٌ بازِلَةٌ : سال دَمُها .<br>\
وخَطْبٌ بازِلٌ : شَدِيدٌ .<br>\
وهو ذو بَزْلَاءَ : طَرِيقةٍ مُحْكَمةٍ .<br>\
وبَزْلُ القَضاءِ : )<br>\
كما يُقال : فَصْلُه وفَتْحُه .<br>\
وبَزَلَ رَأيَه : ابْتَدَعه .<br>\
والبَأْزَلَةُ : مِشْيَةٌ سَرِيعةٌ ، قال : فأصْبحَتْ غَضْبَى تَمَشَّى البَأْزَلَهْ وأحمدُ بن محمّد البُزْلِيّ ، بالضّمّ مُحدِّثٌ ، رَوى عنه حمزةُ بن القاسم الهاشِمِيُّ ، ضَبطه الحافِظ .<br>\
وقال أبو عمرو : ما لفُلانٍ بَزْلاءُ يعيشُ بها : أي صَرِيمةُ رأي .<br>\
وتَبزَّلَ الجَسدُ تَفَطَّرَ بالدَّمِ .<br>\
وتَبَزَّلَ السِّقاءُ كذلك ، وسِقاءٌ فيه بَزْلٌ : يَتَبَزَّلُ بالماء والجَمْعُ : بُزُولٌ .<br>\
' } );