load_data( { book: 'ta_nvd', text: '&lt;شصص&gt;الشِّصُّ ، بالكَسْرِ : حَدِيدَةٌ عَقْفاءٌ يُصَادُ بها السَّمَكُ .<br>\
ويُفْتَحُ ، ذَكَر الجَوْهَرِيّ اللُّغَتَيْنِ .<br>\
وقال ابنُ دُرَيْد : لا أَحْسَبُ هذَا الّذِي يُسَمَّى شِصّاً عَرَبِياً مَحْضاً .<br>\
قال الصَّاغانيُّ : صَدَقَ ابْنُ دُرَيْد وهو مُعَرَّب ، ويُقَال له بالفَارِسيّة : شستْ .<br>\
والشِّصُّ : اللِّصُّ الحَاذقُ ، الذي لا يَرَى شَيْئاً إِلاّ أَتَى عليه ، ج شُصُوصٌ ، نقله الجَوْهَرِيّ .<br>\
قال ابنُ دُرَيْد : يقال شَصَصْتُه عن الشَّيْءِ ، أَي مَنَعْتُه ، كأَشْصَصْته .<br>\
وسَنَةٌ شَصُوصٌ : جَدْبَةٌ .<br>\
وهي ، أَي الشَّصُوصُ أَيضاً النّاقَةُ الغَلِيظَةُ اللَّبَنِ ، كذا في العُبَابِ .<br>\
وفي الصّحاح : القَليلَةُ اللَّبَنِ ، ولا مُنافَاةَ ، فإِنَّ اللَّبَن إِذا غَلُظَ قَلَّ .<br>\
جَمْعه شَصَائصُ وشُصُصٌ وشِصَاصٌ .<br>\
وفي الحديث أَنَّ فُلاناً اعْتَذَرَ إِلَيْهِ مِنْ قِلَّةِ اللَّبَنِ وقال : إِنَّ ماشِيَتَنا لَشُصُصٌ وخَرَجَ حَضْرَمِيُّ بنُ عامِر في حُلَّتَيْن يَتَحَدَّث في مَجْلِس قَوْمِه ، فقال جَزْءُ بْنُ سِنَان ابنِ مَوْأَلة : والله إِنَّ حَضْرَمِيّاً لجَذْلٌ<br>\
بمَوْتِ أَخِيهِ أَنْ وَرِثَهُ .<br>\
فقال حَضْرَميّ :  ( يَقُولُ جَزْءٌ ولم يَقُلْ حَدَلاَ  إِنّي تَزوَّجْتُ نَاعِماً جَذِلاَ )   ( إِنْ كُنْتَ أَزْنَنْتَنِي بها كَذِباً  جَزْءُ فلاَقَيْتَ مِثْلَها عَجِلاَ )   ( أَفْرَحُ أَنْ أُرْزَأَ الكِرَامَ وأَنْ  أُورَثَ ذَوْداً شَصَائِصاً نَبَلاَ )  فلَمْ يمكُثُ إِلاّ أَيَّاماً ، حَتَّى دَخَلَ إِخْوَةٌ لجَزْءٍ سَبْعَةٌ في بِئرٍ يَحْفِرُونها ، فأَسنُوا فيها ، فمالَتْ عَلَيْهم جَميعاً وانْهَارَت .<br>\
وقد شَصَّت تَشِصّ شُصُوصاً وشِصَاصاً : صَارَتْ كَذلِك ، أَي قَلِيلَةَ اللَّبَنِ ، وكذلكَ أَشَصَّت ، بالأَلف ، وسَيَأْتِي قرِيباً .<br>\
وشَصَّ فُلانٌ يَشِصُّ شَصَّا : عَضَّ على نَوَاجِذِه صَبْراً .<br>\
وفي العُبَاب : عَضَّ نَوَاجِذَه على شَيْءٍ صَبْراً .<br>\
وشَصَّت المَعيشَةُ تَشِصُّ شُصُوصاً : اشْتَدَّت .<br>\
يُقَال : شَصَّهُ عَنْهُ ، إِذا مَنَعَهُ ، كأَشَصَّهُ ، عن ابن دُرَيْدٍ ، وأَنْشَدَ وقال : هذا البيتُ قَدِيمٌ أَنشَدَه ابنُ الكَلْبِيّ :  ( أَشَصَّ عنه أَخُو ضِدٍّ كتَائِبَهُ  مِنْ بَعْدِ ما أرملوا من أجله بدم )  وهذا قد تَقَدَّم بعَيْنه في كلام المُصَنِّف ، فهو تَكْرَار .<br>\
وما أَدْرِي أَيْنَ شَصَّ : أَيْنَ ذَهَبَ ، قاله ابنُ عَبَّاد .<br>\
والشَّصَاصَاءُ : السَّنَةُ الشَّدِيدَةُ .<br>\
وأَصْلُ الشَّصَصِ والشِّصَاص هو اليُبْسُ ، والجُفُوفُ ، والغِلَظُ ، والشِّدَّة .<br>\
قال الأَصْمَعِيّ : يقال : أَصابَتْهمْ لأْوَاءُ وشَصَاصَاءُ ، إِذا أَصابَتْهم سَنَةٌ شَدِيدَةٌ .<br>\
قال المُفَضِّل : الشَّصَاصَاءُ : المَرْكَبُ السَّوْءُ .<br>\
يُقَال : لَقِيتُه على شَصَاصَاء أَمْرٍ ، أَي على حَدِّ أَمْرٍ وعَجَلَةٍ ، ولَقِيتُه على شَصاصاءَ ، غَيْرَ مُضَافٍ ، ) أَي على عَجَلةٍ ، كأَنَّهُم جَعَلُوه اسْماً لَها ، قالَه الكِسَائِيُّ وأَنْشَدَ : نَحْنُ نَتَجْنَا ناقَةَ الحَجَّاجِ على شَصَاصَاءَ من النِّتَاجِ ومِثْلُ ذلِكَ : على أَوْفازٍ ، وأَوْفَاضٍ .<br>\
أَوْ لَقِيتُه على شَصَاصَاءَ ، أَي علَى حَاجَةٍ لا يَسْتَطِيعُ تَرْكَهَا ، عن ابن بُزُرْج .<br>\
وَأَشَصَّ صاحِبَه عنه ، أَي أَبْعَدَ هُ .<br>\
قال أَبُو عُبَيْدٍ : أَشَصَّت الناقَةُ : قَلَّ لَبَنُهَا جِدّاً ، وقيل : انْقَطَع البَتَّةَ ، قال ابنُ عَبَّادٍ : وهي مُشِصٌّ ، وهو القيَاسُ ، وأَنْكَرَهُ ابنُ سِيدَه .<br>\
قال أَبُو عُبَيْد : شَصُوصٌ من شَصَّت ، قال : وهذ شَاذٌّ .<br>\
والجَمْعُ شَصَائِصُ ، وشِصَاصٌ ، وشُصُصٌ .<br>\
يُقَال : شَاةٌ شُصُصٌ ، بضَمَّتَيْن لِلَّتي ذَهَبَ لَبَنُهَا ، لِلْوَاحِدَةِ والجَمْعِ ، كذا في الصّحاح .<br>\
قال ابنُ بَرِّيّ : والمَشْهُورُ : شَاةٌ شَصُوصٌ وشِيَاهٌ شُصُصٌ ، فإِذا قيلَ : شَاةٌ شُصُصٌ ، فهو وَصْفٌ بالجَمْع ، كحَبْلٍ أَرْمامٍ وثَوبٍ أَخْلاقٍ وما أَشْبَهَه .<br>\
وممّا يُسْتَدْرَك عليه : الشَّصَصُ : النَّكَد ، كالشِّصَاصِ .<br>\
ويُقَال : نَفَى اللهُ عَنْكَ الشَّصَائصَ ، أَي الشَّدَائِدَ .<br>\
ويقال : انكَشَفَ عن النَّاس شَصَاصَاءُ مُنْكَرَةٌ .<br>\
' } );