load_data( { book: 'ta_nvd', text: '&lt;عرص&gt;العَرْصُ ، بالفَتْح : خَشَبَةٌ تُوضَعُ على البَيْت عَرْضاً إِذَا أَرادُوا تَسْقيفَةُ ، ثمّ يُلْقَى عَلَيْه أَطْرَافُ الخَشَبِ القِصَارِ ، قاله أَبُو عُبَيْد ، قال : ومنه حديثُ عائشَةَ رَضيَ اللهُ تعَالَى عَنْهَا أَنَّهَا قالت : نَصَبْتُ على بابِ حُجْرَتي عَبَاءَةً ، وعَلَى مَجَرِّ بَيْتِي ستْراً ، مَقْدَمَهُ من غَزْوَة خَيْبَر ، أَو تَبُوكَ ، فدَخَلَ البَيْت وهَتَكَ العَرْصَ حَتَّى وَقَعَ إِلى الأَرْض .<br>\
ويُقَال فيه : العَرْسُ ، بالسّين .<br>\
وقيل : هو الحائطُ يُجْعَلُ بَيْنَ حائطَي البَيْتِ لا يُبْلَغُ به أَقصَاه ، ثمّ يُوضَعُ الجَائزُ من طَرَف الحَائِط الداخِلِ إِلَى أَقْصَى البَيْت ويُسَقَّفُ البَيْتُ كُلّه ، فما كان بَيْنَ الحَائطَيْنِ فهو سَهْوَةٌ ، وما كَانَ تَحْتَ الجائزِ فهو مُخْدَعٌ .<br>\
قال الأَزْهَريّ : رَوَاه اللَّيْثُ بالصَّاد ، ورَوَاه أَبُو عُبَيْدٍ بالسِّين ، وهُمَا لُغَتَان .<br>\
قال الهَرَويّ :<br>\
والمُحَدِّثُون يَلْحَنُون فيُعْجِمُون الصَّادَ ، ولَيْسَ في نَصّ الهَرَويّ نسْبَةُ اللَّحْنِ لَهُم ، وإِنّمَا قال والمُحَدِّثُون يَرْوُونَه بالضَّاد المعجمة ، وهو بالصّاد والسّين .<br>\
والحَديثُ جاءَ في سُنَن أَبي دَاوُودَ بالضّاد المُعْجَمَة ، وشَرَحَهُ الخَطَّابيُّ في المَعَالم ، وفي غَريب الحَديثِ بالصَّادِ المُهْمَلَة ، وقال : قال الراوِي : العَرْضُ ، وهُوَ غَلَطٌ .<br>\
وقال الزَّمَخْشَريّ : هو بالصَّاد المُهْمَلَة .<br>\
والعَرْصَةُ : كُلُّ بُقعَةٍ بَيْنَ الدُّورِ وَاسِعَةٍ ، لَيْسَ فيها بِنَاءٌ ، سُمِّيَتْ بذلكَ لاعْترَاضِ الصِّبْيَان فيها .<br>\
وقال الأَصْمَعيُّ : كُلُّ جَوْبَةٍ مُنْفتِقَةٍ ليس فيها بنَاءٌ فهي عَرْصَةٌ .<br>\
قال مالكُ بنُ الرَّيْب :  ( تَحَمَّلَ أَصْحَابِي عِشَاءً وغادَرُوا  أَخاثِقَة في عَرْصَةِ الدّارِ ثاوِيَا )  ج عِرَاصٌ ، وعَرَصاتٌ ، وأَعْرَاصٌ .<br>\
قال أَبُو النَّجْم :  ( فَرُبَّمَا عُجْتُ من القِلاصِ  على أَثَافِي الحَيِّ والعِرَاصِ )  وقال أَبو مُحَمَّدٍ الفَقْعَسِيُّ : ) يُلْفَى بقَفٍّ سَبْسَبِ الأَعراصِ وقال جَمِيلٌ :  ( وما يُبْكِيكَ من عَرَصَاتِ دَارٍ  تَقَادَمَ عَهْدُهَا ودَنَا بِلاَهَا )  والعَرْصَتَانِ : كُبْرَى وصُغْرَى بعَقِيقِ المَدِينَةِ ، على ساكنها أَفْضَلُ الصَّلاةِ والسَّلام .<br>\
العَرَّاصُ ، ككّتَّانٍ : السَّحابُ ذُو الرَّعْدِ والبَرْقِ ، وقِيلَ : هو الَّذِي اضْطَرَبَ فيه البَرْقُ وأَظَلَّ من فَوقُ فقَرُبَ حتَّى صارَ كالسَّقْفِ ، ولا يَكُونُ إِلاَّ ذَا رَعْدِ وبَرْقٍ .<br>\
وقال اللِّحْيَانيّ : هو الَّذِي لا يَسْكُن بَرْقُهُ .<br>\
قال ذُو الرُّمَّةِ يَصِفُ ظَليماً :<br>\
( يَرْقَدُّ في ظِلِّ عَرَّاصِ ويَطْرُدُه  حِفيفُ نافِجَةٍ عُثْنُونُهَا حَصِبُ )  يَرْقَدُّ : يُسْرِع في عَدْوِه .<br>\
وعُثْنونُهَا : أَوَّلُهَا .<br>\
وحَصبٌ : يَأْتِي بالحَصْبَاء .<br>\
قِيلَ .<br>\
العَرَّاصُ من السَّحابِ : الكَثِيرُ اللَّمْعَانِ ، عن ابنِ عَبّادٍ ، قال : وقِيلَ : هو الذي يَبْرُقُ تَارَةً ويَخْفَى أُخْرَى ، وقِيلَ : العَرَّاصُ من السَّحاب : ما ذَهَبَتْ به الرِّيحُ وجَاءَتْ .<br>\
قال ابنُ السِّكِّيتِ : العَرَّاصُ من البَرْق : المُضْطَرِبُ الشَّدِيدُ الاضْطِرَاب والرَّعْدِ .<br>\
قال ابنُ دُرَيْدٍ : عَرِصَ البَرْقُ ، كفَرِح ، يَعْرَصُ عَرَصاً وعَرْصاً فهو عَرِصٌ ، ككَتِفٍ ، وعَرْصٌ ، بالفَتْح ، وهو اضْطرابُه في السَّحاب ، فالبَرْقُ عَرّاصٌ ، قال : ورُبَّمَا سُمِّيَ السَّحَابُ عَرَّاصاً ، لاضْطِراب البَرْقِ فيه .<br>\
العَرَّاص : الرُّمْحُ اللَّدْنُ ، أَيْ لَدْنُ المَهَزَّةِ إِذا هُزَّ اضْطَرَبَ ، قَالَهُ أَبُو عَمْرو ، وأَنشد :  ( مِن كُلِّ أَسْمَرَ عَرَّاصٍ مَهَزَّتُه  كَأَنَّه برَجَا عَادِيَّةٍ شَطَنُ )  قال : وكَذَا السَّيْفُ .<br>\
قال أَبو مُحَمَّدِ الفَقْعَسِيُّ ، وقِيلَ لعُكَّاشَةَ الأَسَدِيِّ : مِنْ كُلِّ عَرَّاصٍ إِذا هُزَّ اهْتَزَعْ مِثْل قُدَامَى النَّسْرِ ما مَسَّ بَضَعْ يُقَال : سَيْفٌ عَرّاصٌ ، والفِعْل كالفِعْل ، والمَصْدَر كالمَصْدَرِ .<br>\
وقَال ابنُ عَبّاد : رُمْحٌ عَرَّاصٌ لِلَّذِي إِذا هُزَّ بَرَقَ سِنَانُه ، من عَرِصَ البَرْقُ .<br>\
قال أَبُو زَيْدِ : عَرَصَت السَّمَاءُ ، وفي بعض نُسَخ الصّحاح : السَّحَابَةُ ، تَعْرِصُ عَرْصاً : دَامَ بَرْقُهَا .<br>\
عَرَصَ البَعِيرُ وغَيْرُه : اضْطَرَبَ برِجْلَيْه ، كأَعْرَصَ ، نَقَلَه الصّاغَانيّ في العُبَابِ .<br>\
قال الفَرَّاءُ : العَرَصُ ، مُحَرَّكَةً ، وكَذَا الأَرَنُ : النَّشَاطُ .<br>\
يُقَال : عَرِصَ الرَّجُلُ إِذا نَشِطَ ، كاعْتَرَصَ ، وتَرَصَّعَ .<br>\
قال حُمَيْدُ بنُ ثَوْر :  ( كَأَنَّهَا لَمْعُ بَرْقٍ في ذُرَا قَزَعٍ  يَخْفَى عَلَيْنَا ويَبْدُو تَارَةً عَرِصَا )  )<br>\
وقال اللِّحْيَانِيّ : عَرِصَ الرَّجُلُ : قَفَزَ ، ونَزَا ، والمَعْنَيانِ مُتَقَارِبَان .<br>\
وعَرِصَت الهِرَّةُ ، واعْتَرصَتْ : نَشِطَت ، حكاه ثعلبٌ ، وأَنشد : إِذا اعْتَرَصْتَ كاعْتِرَاصِ الهِوَّهْ يُوشِكُ أَنْ تَسْقُطَ في أُفُرَّهْ الأُفرَّه : البَليَّة والشِّدَّة .<br>\
العَرَصُ أَيضاً : تَغَيَّرُ رائِحَةِ البَيْتِ ، وخُبْثُهَا ونَتْنُهَا ، كذلِك رائحةُ النَّبْتِ ، زاده الصّاغَانِيّ ، واقتَصَرَ الجَوْهَرِيُّ على الأَوّل .<br>\
وبَيْنَ البَيْتِ والنَّبْتِ جِنَاسٌ ومنهُم مَنْ خُصَّ فقال خُبُثَتْ من النَّدَى ، وأَظُنُّ هذا الَّذِي حَمَلَ مَنْ زادَ النَّبْتَ .<br>\
والعَرُوصُ ، كصَبُورٍ : النَّاقَةُ الطَّيِّبَةُ الرَّائِحَة إِذا عَرِقَتْ ، عن ابن الأَعْرَابِيّ .<br>\
قال ابنُ عَبَّادٍ : المِعْرَاصُ : الهِلالُ ، وأَنشد : وصَاحِبٍ أَبْلَجَ كالمِعْرَاصِ قال : وكَأَنَّهُ من عَرِصَ البَرْقُ .<br>\
ولَحْمٌ مُعَرَّصٌ ، كمُعَظَّم : مُلْقىً في العَرْصَةِ لِيَجِفَّ .<br>\
قال الشَّاعِر :  ( سَيَكْفِيكَ صَرْبَ القَوْم لَحْمٌ مُعرَّصٌ  وماءُ قُدُورٍ في القِصَاعِ مَشِيبُ )  ويُرْوَى مُعَرَّض ، بالضاد ، كما في الصّحاح .<br>\
وهذا البيت أَوْرَدَه الأَزْهَرِيّ في التَّهْذِيب للمُخَبَّلِ فقال : وأَنْشَد أَبُو عُبَيْدَةَ بَيْتَ المُخَبَّلِ .<br>\
وقال ابنُ بَرِّيّ : هو للسُّلَيْكِ بْنِ السُّلَكَةِ السَّعْدِيّ ومثْلُه في العُبَابِ .<br>\
أَو لَحْمٌ مُعَرَّصٌ ، أَي مُقَطَّع ، وهذَا قَوْلُ الفَرَّاءِ .<br>\
أَو لَحْمٌ مُعَرَّصٌ : مُلْقىً في الجَمْرِ ، وفي بعض النًّسَخ : على الجَمْرِ ، فَيَخْتَلِطُ بالرَّمَاد ولا يَجُودُ نُضْجُهُ ، فإِذا غَيَّبْته في الجَمْرِ فهو المَمْلُول فإِذا شَوَيْته على حِجَارَةِ أَو مِقْلىً فهو المُضَهَّبُ .<br>\
والمَحْنوذ : المَشْوِيّ بالحجَارة المُحْمَاة خاصّة ، وهذا قولُ اللّيْثِ .<br>\
وقال الأَزهَرِيّ : وقولُ الليْثِ أَعْجَبُ إِلىَّ مَن قوْل الفرّاءِ ، وقد رَوَيْنا عن ابْنِ السِّكِّيت نحْواً من قَوْلِ الليْث .<br>\
قال ابن حَبِيب : بَعِيرٌ مُعَرَّصٌ ، وهو الَّذِي ذَلَّ ظَهْرُه لا رَأْسُهُ ، وكانُوا يَرْكَبُون بغَيْرِ خَطْمٍ فَيَذلُّ ظَهْرُ البَعيرِ ، ولا يَذلُّ رَأْسُه .<br>\
واعْتَرصَ : لَعِبَ ومَرِحَ .<br>\
يُقَال : تَرَكْتُ الصِّبْيَانَ يَعْتَرِصُون ، أَي يَلْعَبُون ويَمْرَحُون ، ومنه أُخِذَت العَرْصَةُ ، كما تَقَدّم .<br>\
اعْتَرَصَ جِلْدُه وارْتَعَصَ : اخْتَلَجَ ، وأَنْشَدَ ابنُ فارِسٍ في المَقَاييس : إِذا اعْتَرَصْتَ كاعْتِرَاصِ الهِرَّهْ أَوْشَكْتَ أَنْ تَسْقُطَ في أُفْرَّهْ وقد تَقَدَّم هذَا عن ثَعْلَب .<br>\
وتَعَرَّص : أَقَامَ .<br>\
ونَصُّ النَّوَادر لابْنِ الأَعْرَابِيّ : يُقَال : تَعَرَّصْ يا فلانُ ، )<br>\
وتَهَجَّسْ ، وتَعَرَّجْ ، أَي أَقمْ .<br>\
وممّا يُسْتَدْرَك عليه : اعْتَرَصَ البَرْقُ : اضْطَرَبَ .<br>\
واعْتَرَصَ الرَّجُلُ : قَفَزَ ونَزَا ، عن اللِّحْيَانيّ .<br>\
وعَرِصَ القَوْمُ كفَرِحَ : لَعِبُوا ، وأَقْبَلُوا وأَدْبَرُوا يُحْضرُون .<br>\
' } );