load_data( { book: 'ta_nvd', text: '&lt;عزق&gt;عَزَق الأرْضَ خاصّة هكذا قيَّده أبو عُبَيْد ، قال : ولا يُقال ذلك لغيْر الأرضِ يعْزِقُها عَزْقاً : شَقّها وكرَبها .<br>\
والمِعْزَق ، والمِعْزَقَةُ ، كمِنْبَر ، ومِكْنَسَة : آلةٌ كالقَدوم ، أو أكْبَرُ منها لعَزْقِ الأرْضِ .<br>\
قال ابنُ بَرّي : المِعْزَقَةُ : ما تُعْزَقُ به الأرْضُ ، فأْساً كانت أو مِسحاةً أو شِكّةً ، قال : وهي البيلة المُعَفَّقة .<br>\
وقال بعضُهم : المَعازِقُ هي الفؤوس ، واحِدُها مِعْزَقَةٌ ، وهي فأسٌ لرأسِها طرَفان .<br>\
وأنشَدَ المُفَضَّل : يا كَفُّ ذوقي نَزَوانَ المِعْزَقَهْ<br>\
وقال ذو الرّمّة :  ( نُثيرُ بها نقْعَ الكُلابِ وأنتُمُ  تُثيرونَ قيعانَ القُرَى بالمَعازِقِ )  وأنشدَهُ ابنُ دُرَيْد ولم يعْزُهُ .<br>\
وقال ابنُ الأعرابيّ : المِعْزَقَة : المِذْرَاةُ التي يُذْرَى بها الطّعامُ ، وأنشدَ اللّيثُ :  ( إنّي ورِثْتُ أبي سِلاحاً كامِلاً  ووَرِثْتُ مِعْزَقَةً وجَرْدَ سِلاحِ )  والعُزُق ، بضمّتين : مُذَرّو الحِنْطَة .<br>\
والعُزُق أيضاً : السَّيّئُو الأخْلاق واحِدُهم عَزِقٌ ، ككَتِفٍ .<br>\
وعزِقَ به : كفَرِح : لصِق مثل عسِقَ به .<br>\
وعزَقَ كنَصَر عَزْقاً : أسرَع في العَدْو .<br>\
وعزَقَ الخَبَرَ عنّي عزْقاً : حَبَسَه عنّي .<br>\
وعزَقْتُه ضرْباً : أثْخَنْتُه .<br>\
وقال ابنُ دُريْد : العَزيق كأمِير : المُطْمَئنُّ من الأرضِ لغةٌ يمانية .<br>\
والعَزّاقَة ، كجبّانة : الاستُ عن ابنِ دُرَيْد .<br>\
والعَزْوَق ، كجَرْوَل وصَبور : حَمْلُ الفُستُقِ في السّنةِ التي لا ينْعَقِد لُبُّه ، وهو دِباغٌ ، قاله اللّيثُ ، وأنشد :  ( ما تصْنَعُ العَنْزُ بذِي عَزْوَقٍ  يُثيبُها في جِلدِها العَزْوَقُ )  وذلِك أنّه يُدبَغ جلدُها بالعَزْوَق .<br>\
وقال ابنُ الأعرابيّ : العَزْوَقُ الفُسْتُق : أو حمْل شجَرٍ فيه بَشاعةُ الطّعْمِ ، نقله ابنُ دُريد .<br>\
قال : وربّما سُمّي الفُسْتُق الفارِعُ عَزْوقاً ، هكذا يقوله الخَليل .<br>\
والعَزِقُ ككَتِفٍ : العسِرُ الخُلُق كالمتُعَزِّق .<br>\
يُقال : رجُلٌ عَزِقٌ<br>\
ومتعزِّق : فيه شدّة وبُخْل وعسَرٌ في خُلُقه ، قاله اللّيثُ .<br>\
ويُقال : هو عَزِق زَنِقٌ زَعِقٌ نَزِقٌ .<br>\
وقال ابنُ فارِس : العيْن والزّاي والقافُ ليْسَ فيه كَلام أصل ، وذكر العَزِق ، والمتَعَزِّق ، وبيْتاً أنشدَه ابنُ دُريْد ، ثم قال : وكُلّ هذا في الضّعْفِ قَريبٌ بعضُه من بعْض .<br>\
قال : وأعجَبُ منه اللّغةُ اليمانيّةُ التي يُدلِّسُها أبو بكر الدُرَيْدي ، قال : ولا نَقول تمَنّيا إلا جَميلاً ، رضي الله عنهم أجمعين .<br>\
ومما يُستدرَك عليه : رجلٌ عَزْوَق ، )<br>\
كجَرْوَل : بخيل متعسِّر .<br>\
والعَزْوَقَة : التقبّض .<br>\
وأرضٌ معْزوقَة : شُقّتْ للزِّراعة .<br>\
وعزَقَه عزْقاً : حفَره حتّى خرج الماءُ منها .<br>\
وأعْزَقَ : عمِل بالمِعْزَقَة .<br>\
وفي الحَديث : لا تعْزِقوا أي : لا تقْطَعوا .<br>\
وعزّقتُ القومَ تعْزيقاً : إذا هزمْتَهم وقتلْتَهم .<br>\
والعَزْق : كنايةٌ عن الأكل ، مولدة .<br>\
' } );