load_data( { book: 'ta_nvd', text: '&lt;خزل&gt;الخَزَلُ ، محرَّكةً ، والتَّخزُّلُ<br>\
والانخِزالُ : مِشْيَةٌ في تَثاقُل وفي العَين : فيها انفِكاكٌ .<br>\
وفي التهذيب : كأنّ الشَّوكَ شاكَ قَدَمَهُ .<br>\
وهي الخَيزَلُ كحَيدَرٍ والخَيزَلَى والخَوْزَلَى .<br>\
وفي التهذيب : هو يَمْشِي الخَيزَلَى والخَوْزَلَى : إذا تَبَخْتَرَ .<br>\
وتَخَزَّلَ السَّحابُ : إذا رأيتَه كأنه يَتَراجَعُ تَثاقُلاً كما في المُحكَم .<br>\
والخُزْلَةُ ، بالضمّ : الكَسرَةُ في الظَّهْر ، خَزِلَ ، كفَرِح ، فهو أَخْزَلُ ومَخْزُولٌ كما في العُباب .<br>\
وقال اللَّيثُ : الأَخْزَلُ : الذي في وسَطِ ظَهْرِه كَسرٌ ، وهو مَخْزُولُ الظَّهر ، وفي ظَهْرِه خُزْلَةٌ ، بالضمّ : أي شيءٌ مِثلُ سَرجٍ ، وقد خَزِلَ يَخْزَلُ خَزَلاً .<br>\
وفي المُحكَم : الخُزْلَةُ والخَزَلُ : الكَسرَةُ مِن الظَّهْر .<br>\
الخُزْلَةُ في الشِّعْر : ضَربٌ مِن زِحافِ الكامِل : وهو سُقُوطُ الألِفِ وسُكونُ التاء مِن مُتَفاعِلُنْ فيَبقَى مُتْفَعِلُن ، وهذا البِناءُ غيرُ مَعْقُولٍ ، فيُصْرَف إلى بِناءٍ مَقُولٍ مَعْقُول هو مُفْتَعِلُنْ ، وبَيتُه :  ( مَنْزِلَة صَمَّ صَداها وَعَفَتْ  أَرْسُمُها إن سُئِلَتْ لم تُجِبِ )  قاله ابن سِيدَه .<br>\
كالخَزْل ، بالفَتح .<br>\
وقال اللَّيث : الخُزْلَةُ : سُقوطُ تاءِ مُتَفاعِلُنْ ، أو مُفاعَلَتُنْ ، كقول الشاعر :  ( وأعطى قَومَه الأنصارَ فَضْلاً  وإخوتَهُمْ مِن المُهاجِرِينَا )  وَتمامُه : المُتهاجِرينا .<br>\
ولا يكون هكذا إلّا في الوافر والكامل ، ومِثلُه قولُ عمرو بن عَبدِ وُدّ : لَقَدْ بَحَحْتُ مِن النِّداءِ لِجَمْعِكُم هَلْ مِن مُبارِزْ<br>\
وَتمامُه : ولَقَدْ .<br>\
ويُسَمَّى هذا أخْزَلَ ومخزولاً .<br>\
وقال الخليلُ : الخَزْلُ : الجَمْعُ بينَ الطَّيِّ والإِضْمار .<br>\
والأَخْزَلُ مِن الإِبِل : ما ذَهَبَ سَنامُه كُلُّه قاله اللَّيث .<br>\
قال الأزهريّ : كأنه أراد الأَجْزَلَ ، بالجيم ، فصَحَّفَ ، وجَعلها خاءً ، ولعلّ الخاءَ والجيمَ يَتعاقَبان في هذا .<br>\
والاخْتِزالُ : الانفِرادُ بالرَّأي .<br>\
الاخْتِزالُ : الحَذْفُ قال ابنُ سِيدَه : ولا أَعْرِفُه عن غيرِ سِيبَويه .<br>\
أيضاً : الاقتِطاعُ يقال : اخْتَزَلَ المالَ : إذا اقْتَطَعَهُ .<br>\
في المُحكَم : انْخَزَل عن جَوابي : إذا لم يَعْبَأْ به ، انْخَزَلَ في كلامِه : انْقطَعَ .<br>\
ويقول القائل إذا أنشد بيتاً فلم يحفَظْه كُلَّه : قد كان عندي خُزْلَةُ هذا البيت : أي الذي يُقِيمُه إذا انْخَزَل ، فذَهب ما يقِيمُه .<br>\
وخَزَلَهُ عن حاجته يَخْزِلُه : عَوَّقَه وحَبَسه ، وفي بعض نُسَخ المحكَم : خَوَّفَه ، وهو غَلطٌ .<br>\
خَزَل الشَّيءَ خَزْلاً : قَطَعَهُ فانْخَزَلَ ، قال الأعشى :  ( مِلْءُ الشِّعارِ وصِفْرُ الدِّرْعِ بَهْكَنَةٌ  إذا تَأَتَّى يكَادُ الخَصْرُ يَنْخَزِلُ )  الخُزَلَةُ كهُمَزَةٍ : مَنْ يَعُوقُكَ عمّا تُرِيدُ ويَحبِسُك عنه ، نقله الأزهريّ .<br>\
)<br>\
ومما يُسْتَدرَك عليه : الأَخْزَلُ : الأعرَج ، عن أبي عمرو .<br>\
وقال ابنُ دُرَيد : خَوْزَلُ : اسمُ امرأةٍ ، والواو زائدةٌ ، مأخوذٌ مِن انخِزالِها في الكَلام : أي انقِطاعِها عنه .<br>\
واخْتَزَلَ الرجُلُ : عَرَجَ .<br>\
والخَوْزَلَةُ : الإِعْياءُ .<br>\
' } );