load_data( { book: 'ta_nvd', text: '&lt;خشع&gt;الخُشُوعُ : الخُضُوعُ : كالاخِتْشاعِ ، والفِعْلُ كمَنَعَ ، يُقَالُ : خَشَعَ يَخْشَعُ خُشُوعاً ، واخْتَشَعَ .<br>\
نَقَلَه الجَوْهَرِيُّ ، وقَالَ اللَّيْثُ : يُقَالُ : اخْتَشَع فُلانٌ ولا يُقَالُ .<br>\
اخْتَشَعَ ببَصَرِهِ .<br>\
أَوْ الخُشُوعُ : قَرِيب المَعْنَى مِن الخُضُوعِ ، قالَهُ اللَّيْثُ .<br>\
أَوْ هو ونَصُّ العَيْنِ : إِلاَّ أَنَّ الخُضُوعَ في البَدَنِ ، وهو الإِقْرَارُ بالاسْتِخْذاءِ ، والخُشُوع في الصَّوْتِ والبَصَرِ .<br>\
قالَ<br>\
اللهُ تَعَالَى : خاشِعَةً أَبْصَارُهُم وقُرِئِ : خَاشِعاً أَبْصَارُهُمْ .<br>\
قالَ الزّجّاجُ : هو مَنْصُوبٌ على الحالِ .<br>\
وخَشَعَ ببَصَرِه ، أَيْ غَضَّهُ ، وهو مَجَازٌ .<br>\
وفي النِّهَايَة : الخُشُوعُ في الصَّوْتِ والبَصَرِ كالخُضُوعِ في البَدَنِ .<br>\
ومِنْهُ حَدِيثُ جابِرٍ : أَنَّهُ أَقْبَلَ عَلَيْنَا ، فقالَ : أَيُّكُمْ يُحِبُّ أَنْ يُعْرِضَ اللهُ عَنْهَ قَالَ : فخَشَعْنَا ، أَي خَشِينَا وخَضَعْنا .<br>\
قالَ : وهكَذَا جَاءَ في كِتَابِ أَبِي مُوسَى ، والَّذِي جاءَ في كِتَابِ مُسْلِمٍ : فجَشِعْنَا بالجِيمِ ، وشَرَحَه الحُمَيْدِيّ في غَريبِه فقالَ : الجَشَعُ : الفَزَعُ والخَوْفُ .<br>\
والخُشُوعُ : السُّكُونُ والتَّذَلُّلُ .<br>\
ومِنْهُ قَوْلُهُ تَعَاَلَى : وخَشَعَتِ الأَصْوَاتُ لِلرَّحْمنِ أَي انْخَفَضَتْ .<br>\
وقِيلَ : سَكَنَتْ .<br>\
وكُلُّ سَاكِنٍ خَاضِعٌ وخَاشِعٌ .<br>\
والخُشُوعُ في الكَوْكَبِ : دُنُوُّهِ مِن الغُرُوبِ ، كما في العُبَابِ ، وهو قَوْلُ أَبِي عَدْنَان وأَبِي صالِحٍ الكِلابيّ .<br>\
أَمّا نَصُّ أَبِي عَدْنَانَ : خَشَعَتِ الكَوَاكَبُ ، إِذا دَنتْ من المَغِيْب ، وخضَعَت أَيْدِي الكَواكب : أَي مالَتْ لتَغِيبَ .<br>\
ونَصُّ أَبِي صالِحٍ : خُشُوعُ الكَوَاكِبِ ، إِذا غارَتْ وكَادَتْ أَن تَغِيبَ في مَغِيبِهَا ، وأَنْشَدَ : بَدْرٌ تَكَادُ لَهُ الكَوَاكِبُ تَخْشَعُ وهو مَجَازٌ .<br>\
ومِنَ المَجَازِ أَيْضاً : الخَاشِعُ : المَكَانُ المُغْبَرُّ لا مَنْزِلَ به .<br>\
وفي الصّحاح : بَلْدَةٌ خَاشِعَةٌ : مُغْبَرَّةٌ لا مَنْزِلَ بها ، ومَكَانٌ خَاشِعٌ .<br>\
وأَنْشَدَ الصّاغَانِيّ لِجَرِيرٍ :  ( لَمَّا أَتَى خَبَرُ الزُّبَيْرِ تَوَاضَعَتْ  سُورُ المَدِينَةِ ، والجِبَالُ الخُشَّعُ )  وقالَ النابِغَةُ الذُّبْيَانِيّ يَصِفُ آثَارَ الدِّيَارِ :<br>\
( رَمَادٌ ككُحْلِ العَيْنِ ما إِنْ تَبِينُه  ونُؤْىٌ كجِذْمِ الحَوضِ أَثْلَمُ خاشِعُ )  وفي اللِّسَان : الخاشِعُ من الأَرْضِ : الَّذِي تُثِيرُه الرِّيَاحُ لِسُهُولَتِه ، فَتَمْحُو آثَارَهُ .<br>\
وقَالَ الزَّجّاج في ) قَوْلِه تَعَالَى : ومِنْ آيَاتِهِ أَنَّكَ تَرَى الأَرْضَ خاشِعَةَ .<br>\
أَيْ مُتَغَيَّرَةً مُتهشِّمَة ، أَرادَ مُتهشِّمَة النَّبَاتِ .<br>\
وقَالَ غَيْرُه : أَيْ مُطْمَئِنَّةً سَاكِنَةً .<br>\
وقَالُوا : إِذا يَبِسَتِ الأَرْضُ ولَمْ تُمْطَرْ قِيلَ : قد خَشَعَتْ .<br>\
وذَكَرَ الآيَة .<br>\
قال : والعَرَبُ تَقُولُ : رَأَيْنا أرْض بَنِي فُلانٍ خَاشعَةً هَامِدَة ، ما فِيهَا خَضْرَاءُ .<br>\
والمَكَانُ الخاشِعُ أَيْضاً : الَّذِي لا يُهْتَدَى له ، نَقَلَهُ الصّاغَانِيّ .<br>\
وقالَ ابنُ دُرَيْدٍ : لِلْخُشُوعِ مَوَاضِعُ : الخَاشِعُ : المُسْتَكِينُ .<br>\
والخاشِعُ : الرَّاكِعُ في بَعْضِ اللُّغَاتِ .<br>\
ومِنَ المَجَازِ : خَشَعَ السَّنَامُ .<br>\
أَيْ سَنَامُ البَعِيرِ ، إِذا ذَهَبَ إِلاّ أَقَلَّهُ ، كَمَا في العُبَابِ .<br>\
وفي اللِّسَانِ : إِذا أُنْضِيَ ، فذَهَبَ شَحْمُهُ ، وتَطَأَطَأَ شَرفُهُ .<br>\
وخَشَعَ فُلانٌ خَرَاشِيَّ صَدْرِهِ فخَشَعَتْ هي : إِذا أَلْقَى بُزَاقاً لَزِجاً ، لازِمٌ مُتَعَدٍّ ، كما في العُبَابِ .<br>\
وقالَ ابنُ دُرَيْدٍ : أَيْ رَمَى بِهَا .<br>\
قال : والخِشْعَةُ ، بالكَسْرِ : الصَّبِيُّ يُلْزَقُ ، هكَذَا فِي النُّسَخِ ، والصَّوابُ : يُبْقَرُ عَنْهُ بَطْنُ أَمِّه إِذا ماتَتْ وهو حَيٌّ ، قالَ ابنُ بَرّيّ .<br>\
قالَ ابنُ خالَوَيْه : والخِشْعَةُ : وَلَدُ البَقِيرِ ، والبَقِيرُ : المَرْأَةُ تَمُوتُ وفي بَطْنِهَا وَلَدٌ حَيٌّ ، فُيبْقَرُ بَطْنُهَا ويُخْرَج ، وكانَ بَكِيرُ بن عَبْدِ العَزيزِ خِشْعَةً .<br>\
قالَ صاحِبُ اللِّسَانِ : ورَأَيْتُ في حاشِيَةِ نُسْخَةٍ من أَمالِي الشَّيْخِ ابْنِ بَرِّيّ مُوْثُوقٍ بِهَا ، قالَ الحُطَيْئَةُ يَمْدَحُ خارِجَةَ بنَ حِصْنِ بنِ حُذَيْفَةَ ابنِ بَدْر :<br>\
( وقَدْ عَلِمَتْ خَيْلُ ابنِ خِشْعَةَ أَنَّهَا  مَتَى تَلْقَ يَوْماً ذَا جِلاَدٍ تُجَالِدِ )  خِشْعَةُ : أُمُّ خَارِجَةَ ، وهي البَقِيرَةُ .<br>\
كانَتْ ماتَت وهو في بَطْنِهَا يَرْتَكِم ، فبُقِرَ بَطْنُهَا فسُمِّيَت البَقيرَة ، وسُمِّيَ خارجَة ، لأَنَّهُمْ أَخْرَجُوهُ من بَطْنِهَا .<br>\
والخُشَعَةُ ، بالضَّمِّ : القِطْعَةُ من الأَرْضِ الغَلِيظَة ، عَنِ ابْنِ دُرَيْدِ .<br>\
وقالَ اللَّيْثُ : الخُشَعَة من الأَرْض : قُفٌّ قد غَلَبَتْ عَليه السُّهُولَةُ ، أَيْ لَيْسَ بحَجَرٍ ولا طِينٍ .<br>\
وقالَ الجَوْهَرِيّ : هي الأَكَمَةُ المُتَوَاضِعَةُ .<br>\
وقالَ ابنُ الأَعْرَابِيّ : العَرَبُ تَقُولُ للْجَثَمَةِ اللاطِئَةِ المُلْتَزْقَةِ بالأَرْضِ هي الخُشْعَةُ والسَّرْوعةُ والقَائدَةُ .<br>\
وج : خُشَعٌ ، كصُرَدٍ .<br>\
قال أَبو زُبَيْدٍ يَصِفُ صُرُوفَ الدَّهْرِ :  ( جَازِعَاتٍ إِلَيْهِمُ خَشَعَ الأَوْ  داةِ قُوتاً تُسْقَى ضَيَاحَ المَدَيدِ )  الأَوْدَاةُ : الأَوْدِيَةُ عَلَى القَلْبِ .<br>\
ويُرْوَى خُشَّع : جَمْع خَاشِع .<br>\
قالَ الجْوَهَرِيّ : وفي الحَدِيثِ : كَانِتِ الأَرْضُ خَاشِعَةً عَلَى الماءِ ، ثُمَّ دُحِيَتْ .<br>\
قُلْتُ : والَّذِي في الغَرِيبَيْنِ للهَرْوِيّ : كَانَتِ الكَعْبَةُ خَاشِعَةً على الماءِ فدُحِيَتْ مِنْهَا الأَرْضُ .<br>\
وفي العُبَابِ مِنْ حَدِيثِ عَبْدِ اللهِ بنِ عُمَرَ ، رَضِيَ اللهُ عَنْهُمَا : خَلَقَ اللهُ البَيت قَبْلَ أَنْ يَخْلُقَ الأَرْضَ بأَلْفِ عامٍ ، وكانَ البَيْتُ زُبْدَةً بَيْضَاءً حِينَ كَانَ العَرْشُ عَلَى الماءِ ، وكانَتِ الأَرْضُ تَحْتَهُ كَأَنَّهَا خَاشِعَةُ علَى الماءِ .<br>\
)<br>\
ويُرْوَى : خَشَفَة ، فدُحِيَت الأَرْضُ مِن تَحْتِهِ ، والخَشَفَةُ : صَخْرَةٌ تَنْبُتُ في البَحْرِ ، وسَيَأْتِي .<br>\
وتَخَشَّعَ : تَضَرَّعَ ، قَالَهُ اللَّيْثُ ، وأَنْشَدَ :  ( ومُدَجَّجٍ يَحْمِي الكَتِيبَةَ لا يُرَى  عِنْدَ البَدِيعَةِ ضَارِعاً يَتَخَشَّعُ )<br>\
وقالَ الجَوْهَرِيّ : التَخَشَّعُ : تَكَلَّفُ الخُشُوعِ .<br>\
وممّا يُسْتَدْرَكُ عَلَيْه : تَخَشَّعَ واخْتَشَعَ : رَمَى ببَصَرِهِ نَحْوَ الأَرْضِ ، وغَضَّهُ ، وخَفَضَ صَوْتَهُ .<br>\
وقَوْمٌ خَشَّعٌ ، كرُكَّعٍ : مُتَخَشِّعُونَ .<br>\
وخَشَعَ بَصَرُهُ : انْكَسَرَ ، قالَ ذو الرُّمَّة :  ( تَجَلَّى السُّرَى عَنْ كُلِّ خِرْقٍ كأَنَّهُ  صَفِيحَةُ سَيْفٍ طَرْفُه غَيْرُ خَاشِع )  والخُشُوعُ : الخَوْفُ : وبه فُسِّرَ قَوْلُه تَعَالَى : الَّذِين هُمْ فِي صَلاَتِهِمْ خَاشِعُون ، أَي خائِفُون .<br>\
واخْتَشَعَ : إِذا طَأْطَأَ صَدْرَه وتَوَاضَع .<br>\
وقُفٌّ خَاشِعٌ : لاطِيءٌ بالأَرْضِ ، وهو مجاز .<br>\
وجِدَارٌ خاشِعٌ : إِذا تَدَاعَى واسّتَوَى مع الأَرْضِ ، وهو مَجَازٌ .<br>\
ويقَال : خَشَعَت الشمسُ ، وخَسَفَت ، وكَسفَت : بمَعنىً واحدِ ، وهو مجَازٌ .<br>\
ويُقَال : خَشَعَتْ دُونَهُ الأَبْصَارُ ، وهو مَجاز .<br>\
وخُشْعانُ ، بالضَّمِّ : قَرْيَةٌ باليَمَنِ .<br>\
وحَشِيشَةٌ خاشعة : يابِسَةٌ سَاقِطَةٌ عَلَى الأَرْضِ ، وهو مَجَازٌ .<br>\
وكَذَا خَشَعَ الوَرَقُ ، إِذا ذَبُلَ .<br>\
وأَبو طَاهِرٍ بَرَكَاتُ بْنُ إِبْراهِيمَ الخُشُوعِيّ المُسْنِدُ ، لأَنَّ جَدَّهُ الأَعْلَى كانَ يَؤُمُّ النّاسَ فتُوُفِّي في المِحْرَابِ فسُمِّيَ الخُشُوعِيّ ، ذَكَرَهُ الحَافِظُ لمُنْذِرِيّ .<br>\
' } );