load_data( { book: 'ta_nvd', text: '&lt;خضض&gt;الخَضَاضُ ، كسَحَابٍ : الشَّيْءُ اليَسِيرُ من الحُلِيِّ .<br>\
قال القَنَانِيُّ :  ( ولَوْ أَشْرَفَتْ من كُفَّةِ السِّتْرِ عَاطِلاً  لَقُلْتَ غَزالٌ مَا عَلَيْه خَضَاضُ )  قال ابنُ بَرِّيّ : ومثْلِهُ قوْل الآخَرِ جَارِيَةٌ في رَمَضَانَ المَاضِي تُقَطِّعُ الحَدِيثَ بالإِيمَاضِ مِثْلُ الغَزَالِ زِينَ بالخَضَاض قَبَّاءُ ذَاتُ كَفَلٍ رَضْرَاضِ والخَضَاضُ : الأَحْمَقُ ، كالخَضَاضَةِ ، يُقَال : رَجُلٌخَضَاضٌ وخَضَاضَةٌ ، أَيْ أَحْمَقُ ، نَقَلَه الجَوْهَرِيّ .<br>\
الخَضَاضُ : المِدَادُ ، والنِّقْسُ ، رُبما يُكْسَر ، قالَهُ الجَوْهَرِيّ .<br>\
الخَضَاضُ : مِخْنَقَةُ السَّنَّوْرِ ، أَو مِخْنَقَةُ الغَزَالِ .<br>\
الخَضَاضُ : غُلُّ الأَسِيرِ ، نقَلَه الصَّاغَانِيُّ .<br>\
الخَضَضُ ، مُحَرَّكَةً ، مَقْصُورٌ منه ، كَمَا في العُبَاب ، وأَيْضاً : أَلْوانُ الطَّعَامِ .<br>\
عن ابنِ بُزُرْجَ .<br>\
الخَضَضُ : الخَرَزُ البِيضُ الصِّغَارُ ، يَلْبَسُهَا الصِّغَارُ من الإِمَاءِ ، نقله الجَوْهَرِيّ والجَمَاعَةُ .<br>\
وأَنْشَدُوا :  ( إِنَّ قُرُومَ خَطْمَةَ أَنزَلَتْنِي  بِحَيْثُ يُرَى من الخَضَضِ الخُرُوتُ )  ) وخَضَّضَها تَخْضِيضاً : زَيَّنَهَا به نقَلَه الصَّاغَانِيُّ .<br>\
قال اللَّيْثُ : الخَضِيضُ : المَكَانُ المُتَتَرِّب تَبُلُّه الأَمْطَارُ .<br>\
والخَضْخَاضُ : ضَرْبٌ من القَطِرَانِ ، تُهْنَأُ له الإِبِلُ ، هذا نَصُّ الصَّحاح وقال الأَزْهَرِيّ : بل هُوَ نِفْطٌ أَسْوَدُ رَقِيقٌ لا خُثُورَةَ فيه ، تُهْنَأُ بهِ الإِبِلُ الجُرْبُ ، ولَيْس بالقَطِرَانِ ، لأَنّ القَطرانَ عُصَارَةُ شَجَرٍ مَعْرُوفٍ ، وفِيه خُثُورَةٌ ، يُدَاوَى به دَبَرُ البَعِيرِ ، ولا يُطْلَى به الجَرَبُ وشَجَرُهُ يَنْبُتُ في جبَال الشَّام ، يُقَالُ له العَرْعَرُ .<br>\
وأَمّا الخَضْخَاضُ فإِنَّهُ دَسِمٌ رَقِيقٌ يَنْبُعُ من عَيْن تَحْتَ الأَرْضِ .<br>\
قُلْتُ : وهذَا سَبَبُ عُدُولِ المُصَنِّفُ عَنْ عِبَارَةِ الصّحاح .<br>\
ولَمَّا لَمْ يَطَّلِعْ شَيْخُنا على ما ذَكَره الأَزْهَرِيّ اعْتَرضَ على المُصَنِّف وقال : إِنَّ عِبَارَةُ الجَوْهَرِيّ أَسْهَلُ وأَقْرَبُ .<br>\
والخُضَاخِضُ ، بالضَّمّ : الكَثِيرُ الماءِ والشَّجَرِ من الأَمْكِنَةِ نَقَلَه الجَوْهَرِيُّ وأَنْشَدَ :  ( خُضَاخِضَةٌ بخَضِيع السُّيُو  لِ قدْ بَلَغَ السَّيْلُ حِذْفَارَهَا )  قال ابنُ بَرِّيّ : البَيْتُ لحاجِزِ بْنِ عَوْفٍ .<br>\
وحِذْفارُهَا : أَعْلاها .<br>\
وقال غَيْرُهُ : البَيْتُ لابْنِ وَدَاعَةَ الهُذَلِيّ ، ويُرْوَى : قَدْ بَلَغَ المَاءُ جَرْجَارَهَا قال ابنُ عَبَّادٍ : الخُضَاخِضُ :<br>\
السَّمِينُ البَطِينُ من الرِّجَال والجِمَالِ ، كالخُضَاخِضَةِ .<br>\
والخُضخض ، كهُدْهُدٍ وعُلَبِطٍ ، ولم يَذْكُر ابنُ عَبَّادٍ الخُضْخُضِ مِثَال هُدْهُدٍ ، وإِنَّمَا ذَكَرَه الأَصْمَعِيّ ، قال : جَمَلٌ خُضَاخِضٌ وخُضخضٌ ، مثل عُلاَبِطٍ وعُلَبِطٍ وهُدْهُدٍ ، إِذا كانَ يَتَمَخَّضُ مِن لِينِ البَدَنِ والسَّمَنِ .<br>\
وقَال غَيْرُهُ : الخُضَاخِضُ : الحَسَنُ الضَّخْمُ مِنَ الرَّجَالِ ، والجَمْع خَضَاخِضُ ، بالفَتْح ، نَقَلَه الأَزْهَرِيّ .<br>\
وقيل : رَجُلٌ خُضْخُضٌ : عَظِيمُ الجَنْبَيْن .<br>\
والخُضَاخِضُ : رِيحٌ تَهُبُّ بَيْنَ الصَّبَا والدَّبُور ، هكذا زَعَمَه المُنْتَجِع ، وهي الإِيرُ أَيضاً ، لا تُصْرَفُ ، أَو رِيحٌ تَهُبّ من المَشْرِقِ ، كذا زَعَمَهُ أَبو خَيْرَةَ ، ولم يَعْرِفْهَا أَبُو الدُّقَيْش ، ذَكَرَ ذلِكَ كُلَّه شَمِرٌ في كِتَابِ الرِّيَاح .<br>\
والخَضْخَضَةُ : تَحْرِيكُ المَاءِ والسَّوِيقِ ونَحْوِه .<br>\
وفي العُبَابِ : ونَحْوِهما ، وأَنْشَدَ لِصَخْرِ الغَيّ الهُذَلِيّ .<br>\
( ومَاءٍ ورَدْتُ عَلَى زَوْرَةٍ  كمَشْيِ السَّبَنْتَى يَرَاحُ الشَّفِيفَا )  (فخَضْخَضْتُ صُفْنِيَ في جَمِّه خِيَاضَ لمُدَابِرِ قِدْحاً عَطُوفَا) وأَصلُ الخَضْخَضَةِ مِنْ خَاضَ يَخُوضُ ، لا من خَضَّ يَخُضُّ .<br>\
يقال : خَضْخَضْت دَلْوِي في الماءِ خَضْخَضَةً ، أَلاَ تَرَى الهُذَلِيَّ جَعَلَ مَصْدَرَه الخِيَاضَ ، وهو فِعَالٌ من خَاضَ .<br>\
والخَضْخَضَةُ المَنْهِيُّ ) عَنْهَا في الحَدِيث هو الاستِمْناءُ باليَدِ ، أَي استِنْزَالُ المَنِيِّ في غَيْرِ الفَرْج .<br>\
وسُئل ابنُ عَبَّاسٍ عن الخَضْخَضَةِ فقال : هُوَ خَيْرٌ مِنَ الزِّنَا ، ونِكَاحُ الأَمَة خَيْرٌ منه والكَلِمَة مُضَاعَفَة صُورَةً ، وأَصْلُهَا المُعْتَلّ .<br>\
وتَخَضْخَضَ الماءُ : تَحَرَّكَ ، وهُوَ مُطَاوِعٌ لِخَضْخَضْتُه .<br>\
قال ابنُ فارِسٍ : خَاضَضْتُه :<br>\
بايَعْتُه مُعَاوَضَةً ، كما في العُبَابِ .<br>\
وممّا يُسْتَدْرَك عليه : الخَضَضُ ، مُحَرَّكَةً : السَّقَطُ في المَنْطِق .<br>\
ويُوصَفُ به فيُقَالُ : مَنْطِقٌ خَضَضٌ .<br>\
ومَكَانٌ خَضِيضٌ : مَبْلُولٌ بالماءِ ، كخُضَاخِضٍ ، مثل عُلاَبِطٍ .<br>\
وقال اللَّيْثُ : خَضْخَضْتُ الأَرْضَ ، إِذا قَلَبْتَها حَتَّى يَصِيرَ مَوْضِعُهَا مُثَاراً رِخْواً ، إِذا وَصَلَ الماءُ إِلَيْهَا أَنْبَتَت .<br>\
وخَضْخَضَ الحِمَارُ الأَتَانَ : خَالَطَهَا .<br>\
ويُقَال : وَجَأَهُ بالخِنْجَرِ فخَضْخَضَ به بَطْنَهُ .<br>\
وقال الفَرَّاءُ : نَبْتٌ خُضَخِضٌ ، وخُضَاخِضٌ : كَثِيرُ الماء : نَاعِمٌ رَيَّانُ .<br>\
' } );