load_data( { book: 'ta_nvd', text: '&lt;نزز&gt;النَّزُّ : ما يَتَحَلَّبُ من الأرض من الماء ، ويُكسَر ، والكَرُ أَجْوَدُ ، فارسيٌّ مُعرَّبٌ .<br>\
النَّزُّ : الكثير .<br>\
النَّزُّ : الذَّكِيُّ الفؤاد الظريفُ الخفيفُ الرُّوحِ العاقِل ، عن أبي عُبَيْدة ، قال الشاعر : في حاجةِ القَومِ خُفَاقاً نَزَّا النَّزُّ أيضاً : السَّخِيُّ ، نقله الصَّاغانِيّ .<br>\
النَّزُّ أيضاً : الطَّيَّاش .<br>\
وهو ذَمٌّ ، قال البَعيثُ ، كما في التكملة ، والصوابُ : قال جَريرٌ يَهْجُو البَعيث :  ( لَقىً حَمَلَتْه أمُّه وَهْيَ ضَيْفَةٌ  فجاءَتْ بنَزٍّ منْ نُزَالَةِ أَرْشَما )  أي من ماءِ عَبْدٍ أَرْشَمَ .<br>\
النَّزُّ : الرجلُ الكثيرُ التَّحرُّكِ كالمِنَزِّ بكسر الميم .<br>\
ونَزَّ الظَّبيُ يَنِزُّ نَزيزاً : عَدا وأَسْرَعَ .<br>\
كذلك إذا صَوَّتَ ، عن أبي الجَرّاح ، حكاه الكسائيُّ ، كما في الصحاح ، قال ذو الرُّمَّة :  ( فَلاةٌ يَنِزُّ الظَّبْيُ في حَجَرَاتِها  نَزيزَ خِطامِ القَوسِ يُحْذي بها النَّبْلُ )<br>\
نَزَّت الأرضُ .<br>\
وفي الصحاح : أَنَزَّتْ : تحَلَّبَ منها النَّزُّ ، أو صارتْ ذاتَ نَزٍّ ، أو صارت مَنابِعَ ، هكذا في سائرِ الأصول بموَحَّدة ، ومثلُه في التكملة ، والذي في المُحكَم : مَناقِعُ للنَّزِّ ، بالقاف .<br>\
نَزَّ عنِّي : انفردَ جانِباً .<br>\
قَتَلَتْه النِّزَّة ، بالكَسْر ، أي الشَّهْوة .<br>\
في نوادر ابْن الأَعْرابِيّ : النَّزيز ، كأميرٍ : الشَّهْوان .<br>\
في التكملة : النَّزيز : الظَّريف ، كالنَّزّ .<br>\
النَّزيز : اضطرابُ الوَتَرِ عند الرَّمْي .<br>\
نَزَّ الرجلُ يَنِزُّ ، من حدِّ ضَرَبَ ، وكذلك الوتَر .<br>\
وأَنَزَّ : تصَلَّبَ وتشَدَّد ، نقله الصَّاغانِيّ .<br>\
والمُنازَّة : المُعازَّةُ والمُنافَسة .<br>\
والنَّزْنَزَة : تَحْرِيكُ الرأس .<br>\
والنُّزانِز ، بالضَّمّ : القَريعُ من الفُحول ، نقلهما الصَّاغانِيّ .<br>\
ونَزَّزَه عن كذا ، أي نَزَّهَه ، كذا في اللِّسان .<br>\
نَزَّزَت الظَّبيَةُ تَنْزِيزاً : رَبَّتْ وَلَدَها طِفلاً .<br>\
يقال : هو نَزيزُ شَرٍّ ، كأميرٍ : ونِزازُه ككِتابٍ ، أي لَزيزُه ولِزازُه .<br>\
ولم يذكر لِزازً في موضعه ، وإنّما ذَكَرَ : لِزّه ولَزيزَه ، وقد أشرنا هناك .<br>\
والمِنَزُّ ، بكسر الميم : المَهْد مَهْدُ الصَّبيِّ ، سُمِّي بذلك لكَثرَة حَرَكَتِه .<br>\
وظَليمٌ نَزٌّ : سريعٌ لا يَسْتَقِرُّ في مكانٍ ، قال : أَوْ بَشَكى وَخْدَ الظَّليمِ النَّزِّ وَخْدَ ، بدَلٌ من بَشَكَى ، أو منصوبٌ على المصدر .<br>\
ومِمّا يُسْتَدْرَك عليه : أنَزَّت الأرض : نَبَعَ منها النَّزُّ .<br>\
وأنَزَّت : صارتْ ذاتَ نَزٍّ .<br>\
وأرضٌ نازَّةٌ ونَزَّةٌ : ذاتُ نَزٍّ ، كلتاهما عن اللِّحْيانيّ .<br>\
وناقةٌ نَزَّةٌ : خفيفةٌ ، وبعيرٌ نَزٌّ : خفيفٌ ، قال الشاعر : )  ( عَهْدِي بجَنّاح إذا ما اهتَزَّا  وأَذْرَت الرِّيحُ تُراباً نَزَّا )  أنْ سَوْفَ يُمْطيهِ وما ارْمَأَزَّا أي يمضي عليه ، ونَزَّا ، أي خفيفاً .<br>\
والنَّزَاز ، بالكَسْر : المُنازَعةُ والمُنافَسة ، والعامَّةُ تقول : نَزْنَازٌ .<br>\
والنَّزَّة ، بالفَتْح : موضعٌ من حَوْفِ رَمْسِيسَ بمِصر ، وقد وَرَدْتُه .<br>\
' } );