load_data( { book: 'ta_nvd', text: '&lt;نشز&gt;النَّشْزُ : المكانُ .<br>\
وفي المُحكَم : المَتْنُ المُرتَفعُ من الأرض ، كالنِّشَاز ، بالفَتْح ، والنَّشَز مُحرّكةً وقيل ، النَّشْزُ والنَّشَز : ما ارتفعَ عن الوادي إلى الأرض ، وليس بالغَليظ .<br>\
ج ، أي جَمْعُ النَّشْز بالفَتْح نُشوزٌ .<br>\
جَمْعُ المُحرَّكِ أَنْشَازٌ ، كَسَبَب وأَسْبَاب ، ونِشازٌ مثلُ جَبَل وأَجْبَال وجِبال .<br>\
النَّشْز : الارتفاعُ في مكانٍ .<br>\
وقد نَشَزَ الرجلُ في مَجْلِسه يَنْشُزُ ويَنْشِزُ ، بالضَّمّ والكَسْر : ارتفعَ قليلاً : ونَشَزَ : أَشْرَفَ على نَشْزٍ من الأرض وظَهَرَ .<br>\
ويقال : اقْعُدْ على ذلك النَّشَاز .<br>\
وفي الحديث : كان إذا أَوْفَى على نَشَزٍ كَبَّر أي ارتفعَ على رابية في سَفَرٍ ، يُروى بالتّحريكِ والتَّسْكين .<br>\
ونَشَزَ بقِرنِه يَنْشِزُ به نَشْزَاً : احْتملَه فَصَرَعه .<br>\
قال شَمِرٌ : وهذا كأنّه مقلوبٌ مثلُ جَبَذَ وجَذَبَ .<br>\
نَشَزَتْ نَفْسُه : جاشَتْ من فَزَعٍ .<br>\
منَ المَجاز : نَشَزَت المرأةُ بزَوجِها ، وعلى وَزْجِها : تَنْشُزُ وتَنْشِزُ نُشوزاً ، وهي ناشِزٌ : اسْتَعصتْ على زَوْجِها وارْتفعَتْ عليه وأَبْغَضَتْه ، وخَرَجَتْ عن طاعته ، وفَرِكَتْه ، وقد تكَرَّرَ ذِكرُ النُّشوز في القرآن والأحاديث ، وهو أن يكونُ بين الزَّوْجَيْن ، قال أبو إسحاق : وهو كَراهةُ كلِّ واحدٍ منهما صاحبَه ، وسُوءُ عِشْرَته له ، واشْتِقاقُه من النَّشْز ، وهو ما ارتفع من الأرض .<br>\
نَشَزَ بَعْلُها عليها يَنْشُزُ نُشوزاً : ضَرَبَها وجَفاها وأَضَرَّ بها ، قال اللهُ تعالى : وإنْ امرأةٌ خافَتْ مِن بَعْلِها نُشوزاً أو إعْراضاً وعِرْقٌ ناشزٌ : مُنْتَبِرٌ ، أي مُرتَفِعٌ لا يزالُ يضربُ ، من داءٍ أو غيرِه .<br>\
وقَلبٌ ناشِزٌ : ارتفعَ عن مكانِه رُعْباً ، أي من الرُّعْب .<br>\
وأَنْشَزَ عِظامَ المَيِّت إنْشازاً : رَفَعَها إلى مَواضِعها ، ورَكَّبَ بَعْضَها على بعضٍ ، وبه فُسِّرَ قَوْله تَعالى : وانظُر إلى العِظامِ كيفَ نُنْشِزُها ثمّ نَكْسُوها لَحْمَاً قال الفَرّاء : قرأ زيدُ بنُ ثابت نُنْشِزُها بالزاي ، والكُوفيُّون بالراء .<br>\
قال ثعلبٌ : والمُختارُ بالزاي .<br>\
أَنْشَزَ الشيءَ : رَفَعَه عن مكانِه ، ومنه الحديث : لا رَضاعَ إلاّ ما أَنْشَزَ العَظمَ أي رَفَعَه وأَعْلاه ، وأَكْبَرَ حَجْمَه .<br>\
والنَّشْزُ ، محرّكةً .<br>\
الرجلُ المُسِنُّ القويُّ ، أي الذي أَسَنَّ ولم يَنْقُصْ ، نقله الجَوْهَرِيّ عن ابن السِّكِّيت ،<br>\
ويقال : إنّه لَنَشَزٌ من الرِّجال ، وَصَتَمٌ ، إذا انتهى سِنُّه وقُوَّتُه وشَبابُه .<br>\
وَتَنَشَّزَ له : مثلُ تشَزَّنَ ، وسيُذكَرُ في مَوْضِعه .<br>\
)<br>\
ومِمّا يُسْتَدْرَك عليه : رجلٌ ناشِزُ الجَبهَةِ ، أي مُرتفِعُها .<br>\
ولَحْمَةٌ ناشِزَةٌ : مُرتفعةٌ على الجِسم .<br>\
تَلٌّ ناشِزٌ : مُرتَفِعٌ ، وجَمْعُه نَواشِز .<br>\
وفي القرآن : وإذا قيل انْشُزوا فانْشُزوا قال الفَرّاء : قَرَأَها الناسُ بكسرِ الشِّين والحِجازِيُّون يَرْفَعونَها ، قال : وهما لغتان .<br>\
قال أبو إسحاق : معناه إذا قيل انْهَضوا فانهَضوا وقُوموا .<br>\
ويقال : نَشَزَ الرجلُ يَنْشِزُ ، إذا كان قاعداً فقام .<br>\
ورَكَبٌ ناشِزٌ : ناتِئٌ مرتَفِعٌ .<br>\
وقولُ الشاعر ، أنشده ابْن الأَعْرابِيّ :  ( فما لَيْلَى بناشِزَةِ القُصَيْرى  ولا وَقْصَاءَ لِبْسَيُها اعْتِجارُ )  فَسَّرَه فقال : ناشِزَةُ القُصَيْرى ، أي ليست بضَخمةِ الجَنْبَيْن مُشرِفَةِ القُصَيْرى بما عليها من اللحم .<br>\
ورجلٌ نَشَزٌ : غليظٌ عَبْلٌ ، قال الأعشى :  ( وتَركبُ منِّي إنْ بَلَوْتَ نَكيثَتي  على نَشَزٍ قد شابَ ليس بتَوْأَمِ )  أي غِلَظٍ ، ذَهَبَ إلى تَعْظِيمه ، فلذلك جَعَلَه أَشْيَب .<br>\
ونَشَزَ بالقوم في الخُصومة نُشوزاً : نَهَضَ بهم للخُصومة .<br>\
وقال أبو عُبَيْد : النَّشَز والنَّشْزُ : الغليظُ الشديد .<br>\
ودابَّةٌ نَشيزَة ، إذا لم يَكَدْ يَسْتَقِرُّ الراكبُ على ظَهْرِها .<br>\
ويقال للدابَّةِ إذا لم يكد يستقرُّ السَّرْجُ والراكبُ على ظَهْرِها : إنّها لنَشِزَةٌ ، قاله الليث .<br>\
وقال ابنُ القَطّاع : نَشَزَ القومُ في مَجْلِسهم : تقَبَّضوا لجُلَسائهم ، وأيضاً قاموا منه .<br>\
' } );