load_data( { book: 'ta_nvd', text: '&lt;نوص&gt;النَّوْصُ : التَّأَخُّر ، نقله الجَوْهَرِيّ ، عن الفَرّاءِ ، وأَنشد لامْرِئ القَيْسِ :  ( أَمِنْ ذِكْرِ سَلْمَى إِذْ نَأَتْك تَنُوصُ  فتَقْصُرُ عنها خَطْوَةً وتَبُوصُ )  والبَوْصُ ، بالبَاءِ : التَّقَدُّم ، كما سَبَقَ .<br>\
النَّوْصُ : الحِمَارُ الوَحْشِيُّ ، نَقَلَه الجَوْهَرِيّ ، وفي اللّسَان : لأَنَّه لا يَزالُ نَائصاً ، أَي رَافِعاً رَأْسَهُ يَتَرَدَّدُ ، كالنَّافِرِ الجَامحِ ، قاله اللًّيْثُ .<br>\
والمَنَاصُ : المَلْجَأُ ، والمَفَرُّ ، نَقَلَه الجَوْهَرِيّ .<br>\
وقال في قَوْلِه تَعَالَى : ولاَتَ حينَ مَنَاصٍ أَي ليْسَ وَقْتَ تَأَخُّرٍ وفِرَارٍ .<br>\
وقال الأَزْهَرِيُّ : أَي لاتَ حِينَ مَهْرَبٍ .<br>\
وقال غيْرُهُ ، أَي وَقْتَ مَطْلَبٍ ومَغَاثٍ .<br>\
ونَاصَ يَنُوصُ مَنَاصاً ونَوِيصاً ، كأَمِيرٍ ، ونِيِاصَةً ، بالكَسْرِ ، ونَوْصاً ، بالفَتْح ، ونَوَصَاناً ، بالتَّحْرِيك : تَحَرَّكَ وذَهَبَ .<br>\
وما يَنُوصُ فُلانٌ لحَاجَتي لا يَتَحَرَّكُ .<br>\
وناصَ عَنْه نَوْصاً : تَنَحَّى وفَارَقَهُ ، عن ابن عَبَّادٍ .<br>\
وقال أَبو تُرَابٍ : لاَصَ عَنِ الأَمْرِ ، ونَاصَ ، بمَعْنَى حادَ .<br>\
وقال غيْرُهُ : نَاصَ يَنُوصُ نَوْصاً : عَدَلَ .<br>\
ناصَ إِليْه نَوْصاً : نَهَضَ .<br>\
قال ابنُ الأَعْرَابِيّ : النَّوْصَةُ : الغَسْلَةُ بالماءِ وغيْرِهِ .<br>\
قال الأَزْهَرِيُّ : والأَصْلُ مَوْصَةٌ ، قُلِبَتْ ميمُه نُوناً .<br>\
وأَناصَهُ أَنْ يَأْخُذَ منه شَيْئاً إِنَاصَةً : أَرادَهُ وقيل أَدَارَهُ .<br>\
وزَعم اللِّحْيَانيّ أَنَّ نُونَه بَدَلٌ من لامِ أَلاَصَهُ .<br>\
ونَاوَصَهُ مُنَاوَصَةً : هَاوَشَهُ ، كذا في النُّسَخ .<br>\
وفي العُبَابِ : نَاوَشَهُ ومَارَسَهُ .<br>\
وعلى الأَخِيرِ اقْتَصَر الجَوْهَرِيّ ، وذَكَرَ المَثَلَ : نَاوَصَ الجَرَّةَ ثُمَّ سَالَمَهَا أَي جَابَذَهَا ومَارَسَهَا .<br>\
قال : وقد فَسَّرناهُ عِنْدَ ذِكْرِ الجَرَّةِ ، قُلْتُ : وقد سَبَقَ للمُصَنِّف أَيْضاً هُنَاكَ ، وكان الواجِبُ عليه أَن يُشيرَ هُنَا لِذلِكَ كالجَوْهَرِيّ .<br>\
والاسْتِنَاصَةُ ، في الفَرَس عند الكَبْح ، والتَّحْرِيكُ ، وهو شُمُوخُه برَأْسه ، قاله اللَّيْثُ ، وأَنْشَدَ قَوْلَ حَارِثَةَ بْنِ بَدْر :  ( غَمْرُ الجِرَاءِ إِذا قَصَرْتُ عِنَانَهُ  بِيَدِي اسْتناصَ ورَامَ جَرْيَ المِسْحَلِ )  والاسْتِناصَةُ أَيضاً : أَنْ تَسْتَخِفَّ الرَّجُلَ فتَذْهَبَ به في<br>\
حاجَتِك ، نقله الصَّاغَانِيّ عن ابنِ عَبّادٍ .<br>\
الاسْتِناصَةُ : تَحَرُّكُ الفَرَسِ لِلْجَرْيِ ، وهو بِعَيْنِه قَوْلُ اللّيْثِ الَّذِي تَقَدَّمَ .<br>\
وممّا يُسْتَدْرَكُ عليه : ناصَ لِلْحَرَكَةِ نَوْصاً ، ومَنَاصاً : تَهَيَّأَ .<br>\
والمَنِيصُ كمَقِيلٍ : التَّحَرُّكُ والذَهَابُ .<br>\
وما بِهِ نَوِيصٌ ، كأَمِيرٍ أَي قُوَّةٌ وحَرَاكٌ ، نَقَلَه الجَوْهَرِيّ ، وأَغْفَلَهُ المُصَنِّفُ ، رَحِمَهُ اللهُ تَعالَى .<br>\
ونُصْتُ الشَّيْءَ : جَذَبْتُهُ .<br>\
قال المَرّارُ : وإِذا يُنَاصُ رَأَيْتَهُ كالأَشْوَسِ والمُنَاوَصَةُ : المُجَابَذَةُ .<br>\
ونَاصَ يَنُوص مَنِيصاً ومَنَاصاً : نَجَا هَارِباً .<br>\
وقال أَبو سَعِيدٍ : انْتَاصَتِ الشَّمْسُ انْتِيَاصاً ، إِذا غَابَتْ .<br>\
والنَّوْصُ : الفِرَارُ ونَوْصُ الفَرَسِ اسْتِنَاصَتُه ، عن الليْث .<br>\
ونَاصَ عَنْ قِرْنِهِ يَنُوصُ نَوْصاً ومَنَاصاً : فَرَّ ، ورَاغَ ، نَقَلَه الجَوْهَرِيّ .<br>\
وقال ابنُ بَرِّيّ : النُّوصُ : بالضّمّ الهَرَبُ .<br>\
قال عَدِيُّ بنُ زيْد .<br>\
( يا نَفْسُ أَبْقِي واتَّقِي شَتْمَ ذِي الْ  أَعْرَاضِ إِنَّ الحْلْمَ ما إِنْ يَنُوصْ )  ونَاصَهُ لِيُدْرِكَهُ نَوْصاً : حَرَّكَهُ .<br>\
والنَّوْصُ والمَنَاصُ : السَّخَاءُ ، حَكَاهُ أَبُو عَليٍّ في التَّذْكِرة .<br>\
والمَنِيصُ : الفَرَسُ الشَّامِخُ برَأْسِهِ .<br>\
ونَصْتُ الشَّيْءَ ، أَنُوصُهُ نَوْصاً : طَلَبْتُه ، عن ابنِ دُرَيْدٍ .<br>\
وقال غَيْرُه : أَنْصَتُهُ مِثْلُ نُصْتُه ، بمعنَى طَلبْتُه ، نَقَلَه الصَّاغَانيّ .<br>\
واسْتَنَاصَ ، أَي تَأَخَّرَ .<br>\
والمُنَوَّصُ ، كمُعَظَّمٍ : المُلَطَّخُ ، عن كُرَاع .<br>\
والنَّاصِي : المُعَرْبِدُ ، عن ابن الأَعْرَابِيّ ، هُنَا ذَكَرَه وكَأَنَّه مَقْلُوبُ النّائِصِ .<br>\
' } );