load_data( { book: 'ta_nvd', text: '&lt;هدف&gt;الهَدَفُ ، مُحَرّكَةً : كُلُّ مُرْتَفِعٍ من بناءٍ أَو كَثِيبِ رَمْلٍ أَو جَبَلٍ ومنه الحَدِيثُ : كانَ إذا مَرَّ بهَدَفٍ مائِلٍ ، أو صَدَفٍ مائلٍ أَسْرَعَ المَشْيَ فيِه والجمعُ أَهْدافٌ ، لا يُكَسَّرُ على غَيْرِ ذَلِكَ .<br>\
قال الجَوْهريُّ : ومنه سُمِّيَ الغَرَضُ هَدَفاً ، وهو المُنْتَضَلُ فيِه بالسِّهامِ .<br>\
وقال النّضْرُ : الهَدَفُ : ما رُفِعَ وبُنِىَ من الأَرْضِ للنِّضالِ ، والقِرْطاسُ : ما وُضِعَ في الهَدَفِ ليُرْميَ ، والغَرَضُ : ما يُنْصَبُ شِبْهَ غِرْبالٍ أَو حَلْقَةٍ ، وقال في موضِعٍ آخرَ : الغَرَضُ : الهَدَفُ ، ويُسَمّى القِرْطاسُ غَرَضاً ، وهَدَفاً ، على الاسْتِعارَةِ .<br>\
قال الجَوْهَريُّ : وبه شُبِّه الرَّجُلُ العَظِيمُ وزادَ غيرُه : الجَسِيمُ الطَّويلُ العُنُقِ ، العَرِيضُ الأَلْواحِ ، على التَّشْبِيِه بذلِكَ ، وأَنْشَدَ لأَبِي ذُؤَيْبٍ :  ( إذا الهَدَفُ المِعْزابُ صَوَّبَ رَأْسَه  وأَعْجَبَه ضَفْوٌ من الثَّلَّةِ الخُطْلِ )<br>\
وقال السُّكَّرِيُّ : الهَدَفُ من الرِّجالِ : الثَّقِيلُ النَّؤُومُ الوَخِمُ الذّيِ لا خَيْرَ فيه وبه فُسِّرَ البيتُ المَذْكُورُ وخَطَّأَ مَنْ قالَ : إنّه الرَّجُلُ العَظِيمُ ، وقال أَيضاً في الهَدَفِ المِعْزابِ إنَّه راعِي ضَأْنٍ ، فهو لضَأْنِه هَدَفٌ تَأْوِى إليِه ، وهذا ذَمٌّ للرجُلِ إذا كانَ راعِيَ الضَّأْنِ ، ويُقال : أَحْمَقُ من راعِي الضَّأْنِ .<br>\
وقال ابنُ عَبّادٍ : هَدَفْ هَدَفْ : دُعاءٌ للنَّعْجَةِ إلى الحَلْبِ .<br>\
وفي النّوادِرِ : يُقالُ : هَلْ هَدَفَ )<br>\
إليكُمْ هادِفٌ أَو هَبَشَ هابِشٌ : يَسْتَخْيِرُهُ هَلْ حَدَثَ ببَلَدِكُم أَحَدٌ سِوَى مَنْ كانَ به .<br>\
والهادِفَةُ : الجَماعَةُ يُقال : جاءَتْ هادِفَةٌ من النّاسِ ، وداهِفَةٌ : أَي جماعَةٌ .<br>\
والهِدْفَةُ ، بالَكسْرِ : القِطْعَةُ من النّاسِ والبُيُوتِ مثلُ الخِبْطَةِ يُقِيمُونَ في مواضِعِهم ويَظْعَنُون .<br>\
وقال الأَزْهَرِيُّ : هي الجَماعَةُ الكَثِيرَةُ ، وقال عُقْبَةُ : رأَيْتُ هِدْفَةً من النّاسِ ، أَي : فِرْقَةً ، وقال الأَصْمَعِيُّ : غِدْفَةٌ وغِدَفٌ ، وهِدْفَةٌ وهِدَفٌ بمعنى قِطْعَة .<br>\
وقال ابنُ عَبّادٍ : هَدفَ إليْهِ : أي دَخَلَ إليه ، وفي اللِّسانِ : أَسْرَعَ .<br>\
ومن المَجازِ : هَدَفَ فُلانٌ للخَمْسِينَ : إذا قارَبَها ، كأَهْدَفَ ومنه الحَدِيثُ : قالَ عبدُ الرَّحْمن بنُ أبِي بكْرٍ لأَبِيِة : لَقَدْ أَهْدَفْتَ لِي يَوْمَ بَدْرٍ ، فَضِفْتُ عَنْكَ .<br>\
وهَدَفَ كَضَرَبَ : كَسِلَ ، وضَعُفَ عن ابنِ عَبّادٍ .<br>\
والهِدْفُ ، بالكَسْرِ : الجَسِيمُ الطَّوِيلُ العُنُقِ ، وهو مَجازٌ .<br>\
وأَهْدَفَ عليِه : إِذا أَشْرَفَ .<br>\
وأَهْدَفَ إلَيْهِ : إِذا لَجَأَ وبه فُسِّرَ أَيضاً قولُ عبدِ الرَّحْمنِ بنِ أَبي بَكْرٍ .<br>\
وأَهْدَفَ له الشَّيْءُ : إِذا عَرَضَ لَهُ .<br>\
وأَهْدَفَ مِنْهُ : إذا دَنَا<br>\
ويُقال : أَهْدَفَ الصَّيْدُ فَاْرِمِه ، وأَكْثَبَ ، وأَغْرَضَ مثلُه .<br>\
أَو أَهْدَفَ : إذا انْتَصَبَ واسْتَقْبَلَ وهو قَوْلُ شَمِرٍ ، ونَصُّه : الإِهْدافُ : الدُّنُوُّ منكَ ، والاسْتِقبالُ لكَ ، والانْتِصابُ ، يُقال : أَهْدَفَ لي الشَّيْءُ ، فهو مُهْدِفٌ ، وأَهْدَفَ لي السَّحابُ : إذا انْتَصَبَ ، وأَنْشَدَ .<br>\
ومِنْ بَنِي ضَبَّةَ كَهْفٌ مِكْهَفُ إن سالَ يَوْماً جَمْعُهمْ وأَهْدَفُوا ومن المَجازِ : أَهْدَفَ الكَفَلُ : إذا عَظُمَ وعَرُضَ حَتَّى صارَ كالهَدَفِ نقَلَه الصّاغانِيُّ ، وأَنْشَدَ ابنُ السِّكِّيتِ : لها جَمِيشٌ مُهْدِفٌ مُشْرِفٌ مِثْلُ سَنامِ الرُّبَعِ الكاعِرِ هكذا أَنْشَدَه الصّاغانيِ ،ُّ وجعَلَه شاهِداً على عِظَمِ الكَفَلِ ، وليس كما ذَكَر ، بل هو شاهِدٌ لِعظَمِ الرَّكَبِ ، فإنَّ الجَمِيشَ كما تَقَدَّمَ الرَّكَبُ المَحْلُوقُ ، فتأَمّلْ .<br>\
وقولُهم : من صَنَّفَ فَقَد اسْتَهَدَفَ : أَي انْتَصَبَ وكُلُّ شيءٍ رَأَيْتَه اسْتَقْبَلَكَ اسْتِقبالاً فهو مُهْدِفٌ ومُسْتَهْدِفٌ ، وأَنشَدَ الجَوْهَريُّ لجُبَيْهاءَ الأَسَدِىّ :  ( وحَتَّى سَمِعْنَا خَشْفَ بَيْضاءَ جَعْدَةٍ  على قدَمَيْ مُسْتَهْدِفٍ مُتَقاصِرِ )  قال : يَعْنِي بالمُسْتَهْدِف الحالِبُ يَتَقاصَرُ للحَلْبِ ، يَقُولُ : سَمِعْنَا صَوْتَ الرَّغْوَةِ تَتَساقَطُ على قَدَمِ الحاِلبِ .<br>\
واسْتَهْدَفْ الشيءُ : ارْتَفَع .<br>\
ويُقال : رُكْنٌ مُسْتَهْدِفٌ : أَي عَريضٌ هكذا وقَعَ في سائرِ )<br>\
النُّسَخِ ، ومثلُه في نُسخَِالصِّحاحِ ، والصوابُ : رَكَبٌ مُسْتَهْدِفٌ ومنه قولُ النّابِغَةِ الذُّبْيانِيَّ :  ( وإذا طَعَنْتَ طعَنْتَ في مُسْتَهْدِفِ  رابِي المَجَسَّةِ بالعَبِيِر مُقَرْمَدِ )<br>\
أي : عَرِيض مُرْتَفِعٍ مُنْتِصِب .<br>\
ومما يُسْتَدرَكُ عليه : أَهْدَفَ القومُ : قَرُبُوا ودَنَوْا .<br>\
واسْتَهْدَفَ لكَ الشَّيْءُ : دَنا مِنْكَ .<br>\
وامْرَأَةٌ مُهْدِفَةٌ : لَحِيمَةٌ ، وقيل : مُرْتَفَعةُ الجَهازِ .<br>\
والهادِفُ : الغَرِيبُ .<br>\
' } );