load_data( { book: 'ta_nvd', text: '&lt;هرع&gt;الهَيْرَعُ ، كضَيْغَمٍ : الجَبَانُ الجَزُوعُ ، وقيل : هو الضَّعِيفُ لا يتَمَاسَكُ ، كالهَيْلَعِ ، قال عمرُو ابنُ أحْمَرَ الباهِلِيُّ :  ( ولَسْتُ بهَيْرَعٍ خَفِقٍ حَشاهُ  إذا ما طَيَّرَتْهُ الرِيحُ طَارَا )  وقالَ ابنُ دُرَيْدٍ : رجُلٌ هَيْرَعٌ : جَبَانٌ لا خَيْرَ عِنْدَهُ وأنْشَدَ :  ( ولَسْتُ بذي رَثْيَةٍ هَيْرَعٍ  إذا دُعِيَ القَوْمُ لَمْ أنْهَضِ )  وقالَ ابنُ فارِسٍ : الهَيْرَعُ : الأحْمَقُ .<br>\
والهَيْرَعُ منَ الرِّياحِ : السَّرِيعَةُ الهُبُوبِ ، كما في الصِّحاحِ زادَ ابنُ فارِسٍ : الكَثيرَةُ الغُبَارِ ، أنْشَدَ شَمِرٌ لابْنِ أحْمَرَ يَصِفُ الرِّيحَ :  ( ارَبَّتْ عَلَيْهَا كُلُّ هَوْجاءَ سَهْوَةٍ  زَفُوفِ التَّوَالِي رَحْبَةِ المُتَنَسَّمِ )<br>\
( إبارِيَّةٍ هَوْجَاءَ مَوْعِدُهَا الضُّحَى  إذا أرْزَمَتْ جاءَتْ بوِرْدٍ غَشَمْشَمِ )   ( زَفُوفٍ نيافٍ هَيْرعٍ عَجْرَفِيَّةٍ  تَرَى البِيدَ منْ إعْصَافِها الجَريَ تَرْتَمِي )  والهَيْرَعُ : المَرْأَةُ النَّزِقَةُ ، كالهَوْرَعِ ، كجَوْهَرٍ ، عن ابنِ عبّادٍ .<br>\
)<br>\
والهَيْرَعَةُ بالهاءِ : اليَرَاعَةُ الّتِي يَزْمُرُ فهيا الرّاعِي ، نَقَلَه الجَوْهَرِيُّ وهُوَ قَوْلُ ابنِ دُرَيْدٍ .<br>\
والهَيْرَعَةُ : الخَيْضَعَةُ : وهو الغُبَارُ في الحَرْبِ ، أو اخْتِلاطُ الأصْوَاتِ فيهَا ، كما تَقَدَّمَ .<br>\
والهَيْرَعَةُ : الغُولُ كالهَيْعَرَةِ .<br>\
والهَيرَعَةُ : الشَّبِقَةُ : منَ النِّساءِ ، كالهِرَعَةِ ، بكَسْرِ الرّاءِ ، كِلاهُما عن ابْنِ عَبّادٍ .<br>\
أو الهَرِعَةُ : هي الّتِي تُنْزِلُ حينَ يُخَالِطُها الرَّجُلُ ، كما في الصِّحاحِ زادَ الأزْهَرِيُّ : قَبْلهُ شَبَقاً وحِرْصاً على الرِّجَالِ .<br>\
وقال أبو عَمْرو : الهَرِيعَةُ كسَفِينَةٍ : شَجَرَةٌ دَقِيقَةُ العِيدانِ .<br>\
وقالَ ابنُ دُرَيدٍ : الهِرْياعُ ، كجِرْيالٍ : سَفِيرُ الشَّجَرِ ، وهوَ الوَرَقُ تَنْفُضُه الرِّيحُ ، لغَةُ يمانِيَةٌ .<br>\
والهَرْعَةُ ، والفَرْعَةُ : القَمْلَةُ الصَّغِيرَةُ ، وقيلَ : الضَّخْمَةُ ، والهُرْنُوعُ أكْثَرُ ، ويُحَرَّكُ .<br>\
ويُقَالُ : الهَرَعَةُ بالتَّحْرِيكِ : دُوَيْبَّة .<br>\
وفي الصِّحاحِ : دَمٌ هَرِعٌ ، ككَتِفٍ : جارٍ ، بَيِّنُ الهَرَعِ ، مُحَرَّكَةً ، وقَدْ هَرِعَ كفَرِحَ .<br>\
وفي اللِّسانِ : هَرِعَ فَهُوَ هَرِعٌ : سالَ ، وقيلَ : تتابَعَ في سَيَلانِه .<br>\
ورَجُلٌ هَرِعٌ : سَرِيعُ البُكَاءِ ، نَقَلَه الجَوْهَرِيُّ .<br>\
والهَرَعُ ، مُحَرَّكَةً ، والهُرَاعُ ، كغُرَابٍ : مَشْيٌ في اضْطِرَابٍ وسُرْعَةٍ ، ومنْهُ قَوْلُهم : أقْبَلَ الشَّيْخُ يُهْرَعُ ، بالضَّمِّ : إذا أقْبَلَ يُرْعَدُ ويُسْرِعُ ، قالَهُ أبو عَمْروٍ ، وقال : غَيْرُه هُوَ شِدَّةُ السَّوْقِ ، وسُرْعَةُ العَدْوِ ، وأنْشَدَ ابنُ بَرِّيّ :  ( كأنَّ حُمُولَهُمْ مُتَتابِعاتٍ  رَعِيلٌ يُهْرَعُونَ إلى رَعِيلِ )  وفي التّنْزِيلِ وجاءَهُ قَوْمُه يُهْرَعُونَ إليْهِ قالَ أبو عُبَيْدَةَ : أي يُسْتَحَثُّونَ إليهِ ، كأنَّهُ يَحُثُّ بعْضُهُمْ بعضاً .<br>\
وأُهْرِعَ الرَّجُلُ مَجْهُولاً فهُوَ مُهْرَعٌ ، إذا كانَ يُرْعَدُ منْ غَضَبٍ ، أو ضَعْفٍ كالحُمَّى ، أو خَوْفٍ أو سُرْعَةٍ ، أو حِرْصٍ ، قالَ مُهَلْهِلٌ :  ( فجاءُوا يُهْرَعُونَ وهُمْ أُسارَى  يَقُودُهُمُ على رَغْمِ الأُنُوفِ )  قالَ اللَّيْثُ : أي يُساقُونَ ويعْجَلُونَ ، يُقَالُ : هُرِعُوا وأُهْرِعُوا ، وقال أبو عُبَيدٍ : أُهْرِعَ الرَّجُلُ إهْراعاً : إذا أتاكَ وهُوَ يُرْعَدُ منَ البَرْدِ ، وقَدْ يَكُونُ الرَّجُلُ مُهْرَعاً من الحُمّى والغَضَبِ ، والعَرَبُ تَقُول : أهْرِعُوا وهُرِعُوا فهُمْ مُهْرَعُونَ ، ومَهْرُوعُونَ .<br>\
)<br>\
ويَهْرَعُ كيَمْنَعُ : ع ، نَقَلَه ابنُ دُرَيْدٍ ، قالَ : زَعَمُوا .<br>\
والمَهْرُوعُ : المَجْنُونُ الّذِي يُصْرَعُ ، نَقَلَه الجَوْهَرِيُّ يُقَالُ : هُوَ مَهْرُوعٌ مَخْفُوعٌ ممْسُوسٌ .<br>\
وقالَ أبو عَمروٍ : المَهْرُوعُ : المَصْرُوعُ منَ الجَهْدِ ، ووافَقَه الكِسائِيُّ في ذلكَ .<br>\
والمُهْرِعُ ، والمِهْراعُ ، كمُحْسِنٍ ، ومِصْبَاح : الأسَدُ ، قالَ ابنُ خالَوَيْه : لأنَّهُ فيما يُقَالُ : لا تُفارِقُه الحُمَّى والرِّعْدَةُ .<br>\
وأهْرَعَ : أسْرَعَ في رِعْدَةٍ ، قالَهُ الكسائِيُّ وقالَ أبو العَبّاسِ : في<br>\
طُمَأْنِينَةٍ ، ثمَّ قيلَ له : إسْراعٌ في فَزَعٍ : فقالَ : نَعَمْ .<br>\
وأهْرَعَ القَوْمُ رِمَاحَهُم : أي أشْرَعُوها ، ثُمَّ مَضَوْا بها ، كهَرَّعُوها تَهْرِيعاً وهذهِ عن اللَّيْثِ .<br>\
وتَهَرَّعَتِ الرِّماحُ ، ولو قالَ : وتَهَرَّعَتْ هِيَ ، كانَ أخْصَرَ : أقْبَلَتْ شَوَارِعَ ، وأنْشَدَ اللَّيْثُ : عِنْدَ البَدِيهَةِ والرِّمَاحُ تَهَرَّعُ ومَهْرَعٌ : كمَقْعَدٍ : ع .<br>\
ويُقَالُ : اهْتَرَعَ عُوداً : إذا كَسَرَهُ .<br>\
وذو يَهْرَعَ : ع ، ويُقَالُ : ذُو مَهْرَع .<br>\
وممّا يُسْتَدْرَكُ عليه : الهَرَعُ ، بالتَحْرِيكِ : شدَّةُ السَّوْقِ ، وسُرْعَةُ العَدْوِ ، كالإهْرَاعِ ، وقَدْ هَرَعُوا فَهُم مَهْرُوعُونَ .<br>\
واسْتَهْرَعَتِ الإبِلُ : أسْرَعَتْ إلى الحَوْضِ .<br>\
وأُهْرِعَ الرَّجُلُ بالضَّمِّ : خَفَّ عَقْلُه .<br>\
وتَهَرَّعَ إلَيْهِ : عَجِلَ .<br>\
والمُهْرَعُ ، كمُكْرَمٍ : الحَرِيصُ ، عن أبي عُبَيْدٍ .<br>\
ورَجُلٌ هَرِعٌ ، ككَتِفٍ ، سَرِيعُ المَشْيِ .<br>\
ورِيحٌ هَيْرَعَةٌ : قَصِفَةٌ تأْتِي بالتُّرَابِ .<br>\
والهَرْعَةُ : الخَيْضَعَةُ .<br>\
وقالَ أبو عمروٍ : ظَلَّ يَهْرَعُ في الحَشيشِ ، أي : يَرْعَاهُ ، هُنَا نَقَلَه الصّاغَانِيُّ وسَيَأْتِي في هزع .<br>\
والهَرِيعُ كأمِيرٍ : القَمْلَةُ الصَّغِيرَةُ وقيلَ : هي الهُرْنُعُ بالنُّونِ ، كما سَيَأْتِي .<br>\
' } );